NLC," Entries Standard  ",Entries Reduced,"Entries Seasons ",Exits Standard," Exits Reduced",Exits Seasons,Total Entries and Exits
5131,97651,230854,717520,49260,247779,717520,2060584
3813,11745,17507,14504,12945,17509,14504,88714
3801,5581,14876,4876,6099,14883,4876,51191
3803,6494,10720,4317,6503,10722,4317,43073
3982,18871,48845,11993,18384,48859,11993,158945
8976,226572,488956,70109,206712,488112,70109,1550570
9090,10455,13450,15140,11326,13453,15140,78964
4435,4171,6220,5,4132,6405,5,20938
4440,194,46,0,223,50,0,513
3602,30293,74143,12625,32953,74001,12625,236640
2448,8151,24484,4511,9539,24639,4511,75835
4303,21716,71900,465,20285,71193,465,186024
2552,32290,49722,10028,36191,49986,10028,188245
8600,128,60,0,87,61,0,336
8601,638,617,0,713,612,0,2580
8602,153,215,0,239,215,0,822
7662,274,39,234,159,39,234,979
7286,12987,4267,2611,15558,4264,2611,42298
4529,32861,33236,640,31142,33047,640,131566
2287,1841,838,886,1901,844,886,7196
1404,22755,38877,17650,23190,40212,17650,160334
3000,12085,17224,20591,10822,20083,20591,101396
1036,8539,10375,66,9204,10370,66,38620
9310,1618,1101,552,2023,1101,552,6947
5045,230,259,219,392,386,219,1705
5550,27044,37765,47222,24442,41386,47222,225081
5160,1721,5482,14687,1513,6389,14687,44479
2939,3023,3099,1005,3647,3104,1005,14883
2641,22077,10496,10555,23267,10509,10555,87459
8353,17379,19355,8514,16003,18868,8514,88633
2255,27372,32284,1467,32194,40297,1467,135081
2350,38900,72760,1285,34976,72974,1285,222180
2125,43094,66873,1792,44793,77726,1792,236070
9695,12473,7913,736,12857,7913,736,42628
9759,135679,126336,82783,140039,126323,82783,693943
5132,43024,45984,219889,21926,55381,219889,606093
4614,9691,5812,5475,10276,5904,5475,42633
2760,29170,28281,12096,28227,28301,12096,138171
3145,4989,3361,12485,7513,3558,12485,44391
5623,100521,218490,107553,93321,228148,107553,855586
5280,5354,11620,11335,11048,13151,11335,63843
6025,41456,42368,126989,31694,42650,126989,412146
9905,6405,2049,636,8435,2050,636,20211
9861,64499,61183,12780,62318,61230,12780,274790
1805,21143,33077,4596,22110,33088,4596,118610
7520,6171,3910,3744,6992,3914,3744,28475
2214,2985,2624,564,3263,3180,564,13180
8605,593,437,0,752,439,0,2221
7787,6695,24255,5036,7592,24250,5036,72864
6847,2095,10524,12971,2305,10614,12971,51480
1223,12767,5618,1545,14419,5755,1545,41649
6869,5222,3902,19014,5772,8334,19014,61258
6532,1339,865,408,1255,868,408,5143
8606,20,9,0,60,9,0,98
5544,36865,73010,80135,33256,76888,80135,380289
2806,34426,56257,13775,37700,56813,13775,212746
1198,20937,6297,720,27924,6357,720,62955
1678,6317,4417,1202,6661,4421,1202,24220
5250,1202,10048,1387,1616,11716,1387,27356
4236,1716,1970,275,1761,2097,275,8094
6358,970,76,707,1767,76,707,4303
9965,31819,12775,25755,32121,12708,114,115292
5510,47737,131972,111886,47180,137910,111886,588571
5397,20017,29605,47758,9019,35867,47758,190024
6909,1122,979,1006,4987,1966,1006,11066
5267,21701,100439,60150,19382,104512,60150,366334
9451,5369,10646,1538,6305,10660,1538,36056
9972,123733,67170,49865,127348,67170,49865,485151
2662,8338,6384,330,8375,6460,330,30217
2052,19219,5192,7503,19940,5259,7503,64616
5003,1452,3962,3389,1815,5570,3389,19577
3109,644,1280,1123,1662,1365,1123,7197
2396,8501,19002,10741,9589,20288,10741,78862
1430,22050,50428,42290,22213,50860,42290,230131
9079,40389,62752,15887,39444,62892,15887,237251
8613,743,433,0,809,439,0,2424
9962,813,190,0,863,191,13517,15574
9453,16535,10566,15,21010,10617,15,58758
9569,23676,23209,13121,24160,23213,13121,120500
9455,2341,2122,311,3011,2130,311,10226
2960,150,169,50,407,94,50,920
9961,177453,66036,13517,70454,65312,2761,395533
8821,2702,666,0,2990,664,0,7022
6171,14616,24917,53211,17668,27612,53211,191235
2054,1982,328,865,2444,329,865,6813
1963,17060,16714,5055,19282,16804,5055,79970
8045,413,593,87,529,595,87,2304
9963,1709,793,114,1959,797,0,5372
5251,9950,53344,29209,9516,55568,29209,186796
5666,82463,167332,99012,76018,175021,99012,698858
3003,455,325,365,473,327,365,2310
5641,21342,41197,25998,19277,47803,25998,181615
5547,27264,52397,77123,24704,57236,77123,315847
2941,8724,4948,13829,10064,4997,13829,56391
4700,3246,8629,3332,3588,8687,3332,30814
9953,8109,6809,794,10091,6811,184985,217599
5004,113771,340518,405120,114633,330952,405120,1710114
5667,47416,84457,121235,40472,88665,121235,503480
2850,1110,1276,156,1194,1278,156,5170
5347,49098,107524,168873,37681,123424,168873,655473
2790,20040,42109,14795,19457,45399,14795,156595
5398,297,770,1076,401,897,1076,4517
6083,4988,5716,25838,6106,6909,25838,75395
1953,3949,17759,10527,3606,19509,10527,65877
6233,9423,212,2130,8544,213,2130,22652
2095,5830,2463,1526,5817,2458,1526,19620
1380,1807,5185,3920,1921,5191,3920,21944
1004,23946,40671,303,27441,40866,303,133530
1074,2993,984,319,2808,1060,319,8483
2584,19702,43573,24536,17071,47374,24536,176792
8608,63,53,0,87,56,0,259
1624,11977,1188,1199,13661,1206,1199,30430
6734,3,6,0,5,6,0,20
7367,9494,8781,2425,9904,8799,2425,41828
9457,5248,2679,333,5740,2680,333,17013
7017,38337,81037,200970,36774,89420,200970,647508
2215,16235,15011,11141,17049,15073,11141,85650
8610,9053,17542,11,9669,17586,11,53872
3265,1443,1491,159,1692,1496,159,6440
3200,14511,1563,4551,14294,1572,4551,41042
5714,8636,64899,30104,8352,66338,30104,208433
1492,70423,171331,109623,61411,172887,109623,695298
5162,17319,14835,9750,16218,15010,9750,82882
5197,8748,18870,9880,7938,20166,9880,75482
9463,239229,260664,76271,230122,260657,76271,1143214
2187,16060,15099,3190,15598,15120,3190,68257
4186,3866,5093,1928,4872,5094,1928,22781
5681,10711,14600,14664,13469,16906,14664,85014
8552,43258,25368,2803,51118,24189,2803,149539
9763,12624,10712,3403,15626,10713,3403,56481
5492,4219,10887,23175,4453,13892,23175,79801
6084,19969,35498,56976,21553,38381,56976,229353
5399,172348,315102,335390,135847,329861,335390,1623938
9862,69826,70170,51479,68105,70139,51479,381198
9013,18,53,10,27,53,10,171
2561,23221,5361,4060,22737,5375,4060,64814
2820,4234,3101,170,4034,3102,170,14811
8839,844,114,0,965,113,0,2036
4502,105781,156970,72921,101377,157481,72921,667451
2471,41083,195460,31430,38009,194155,31430,531567
2238,12753,14833,15,15310,20306,15,63232
5348,2280,3372,20488,2701,7724,20488,57053
9466,21238,18087,14568,25035,18087,14568,111583
7563,1429,769,869,1497,767,869,6200
2690,41084,7585,10524,41512,7622,10524,118851
9764,9327,8224,1826,10534,8222,1826,39959
4011,11521,36997,12707,11608,37004,12707,122544
7492,401944,400966,826436,238510,397175,826436,3091467
1279,3732,448,1216,4406,447,1216,11465
5133,5944,8848,17275,5509,9951,17275,64802
4445,21141,29679,20544,19651,29580,20544,141139
5089,68279,93483,393996,35833,104297,393996,1089884
5551,74743,98025,123952,53384,105041,123952,579097
5580,23095,15802,5984,16743,21195,5984,88803
6406,4358,9415,1290,4946,9597,1290,30896
5252,38595,117413,130908,38164,121064,130908,577052
9973,4443,1013,392,5564,1014,392,12818
6774,100784,196983,15311,95120,196626,15311,620135
5725,15461,67526,18353,14682,67592,18353,201967
1096,31695,17806,8330,43463,18247,8330,127871
9674,77726,64135,37270,82448,64137,37270,362986
9467,1063,1399,78,1611,1399,78,5628
6212,1561,7,403,1911,7,403,4292
1954,39113,157706,47009,39355,155111,47009,485303
1903,18471,867,3653,17549,867,3653,45060
3805,40684,75890,41207,39120,75978,41207,314086
3806,17091,32046,8995,17525,32048,8995,116700
3807,13260,76445,20875,17882,76479,20875,225816
9020,13,29,10,24,29,10,115
6207,22770,163,2167,22856,166,2167,50289
7494,158622,241952,376920,137991,252490,376920,1544895
5520,270348,579418,560576,264127,582606,560576,2817651
5090,3041,3980,16849,5437,7100,16849,53256
3271,323665,801301,221069,317306,797031,221069,2681441
9311,104785,59147,45475,106779,59174,45475,420835
8484,20603,17754,454,23740,16777,454,79782
7909,246,752,0,267,749,0,2014
5420,64536,117213,149771,53854,121960,149771,657105
5215,21090,85051,102939,18519,87874,102939,418412
6870,384,1018,1611,1005,1119,1611,6748
6006,457,1584,3547,2258,1598,3547,12991
3047,80005,189485,127580,77481,189925,127580,792056
2420,595,312,15,530,326,15,1793
9966,88263,45977,28870,92965,45983,25755,327813
5091,20633,36781,83210,21279,38972,83210,284085
8822,258,29,0,374,30,0,691
5890,505,1816,1001,641,1834,1001,6798
2188,60035,103583,1733,71218,117805,1733,356107
7258,11558,13358,1343,11579,13347,1343,52528
5076,10019,10656,30268,4905,13271,30268,99387
5046,76859,189100,417750,45493,209170,417750,1356122
5349,58,116,150,269,290,150,1033
1512,79011,400330,404979,82716,417505,404979,1789520
1510,8,38,5,30,38,5,124
5538,16720,14892,10002,17684,15779,10002,85079
3245,3588,2195,2625,4170,2228,2625,17431
1165,6532,2646,1263,7131,2790,1263,21625
3070,5707,13275,8457,5785,15069,8457,56750
1625,52472,29800,21246,52717,29542,21246,207023
5198,3062,4582,7990,3979,4695,7990,32298
2785,1428,4573,257,2388,4825,257,13728
9895,50402,33800,12912,53805,33800,12912,197631
5062,20271,33667,124379,11726,36853,124379,351275
9714,83105,61955,12918,90881,61952,12918,323729
5350,1798,2501,4948,2542,2900,4948,19637
1679,23342,14499,5663,23363,14582,5663,87112
5227,653,984,548,716,1004,548,4453
5092,28422,42261,101211,16382,48197,101211,337684
8047,2199,2405,1355,2139,2406,1355,11859
8564,31775,24946,485,29557,22799,485,110047
7439,155700,220379,768805,138643,241349,768805,2293681
2676,4697,1514,99,5039,1525,99,12973
5624,5494,6495,25779,5550,7473,25779,76570
8352,17128,12715,6064,16284,11776,6064,70031
3549,7849,4666,4354,7985,4667,4354,33875
3550,3817,2412,1407,3729,2412,1407,15184
1390,67679,178537,247371,48511,202397,247371,991866
1045,19809,25304,756,21264,25314,756,93203
7330,182,84,0,405,85,0,756
8431,3871,4216,345,4655,3920,345,17352
5581,15476,15236,26245,12387,17255,26245,112844
7791,56180,80214,2917,56873,79846,2917,278947
5323,3603,15533,18299,2730,17640,18299,76104
2351,1279,797,255,1168,793,255,4547
1003,8223,21614,538,9210,21598,538,61721
2942,0,1,0,11,2,0,14
5472,930,1366,4612,858,1623,4612,14001
6961,5426,7413,9762,27740,7845,9762,67948
2449,17295,3153,477,16984,3187,477,41573
8048,74831,103984,89008,77659,104083,89008,538573
5211,52201,151742,86470,55959,154015,86470,586857
5093,47048,67483,230860,28504,78475,230860,683230
5094,132495,173611,646133,73215,199640,646133,1871227
1006,65022,32041,600,6432,26700,600,131395
3048,31989,70884,57289,33432,71029,57289,321912
3104,3731,9015,5628,4352,9120,5628,37474
5063,37660,57140,132769,25188,64067,132769,449593
2136,19192,18763,447,15861,20612,447,75322
6170,28658,65420,106850,27250,73849,106850,408877
4618,6305,4209,2247,6192,4220,2247,25420
6871,121677,241232,882778,91979,268980,882778,2489424
7910,8553,5979,2619,9618,6010,2619,35398
5464,12367,47308,73458,10293,49389,73458,266273
6235,7989,1688,1747,8971,1691,1747,23833
8553,92053,73693,6301,101531,70814,6301,350693
3907,7730,10337,4410,7348,10340,4410,44575
5163,6882,28066,39578,6315,28342,39578,148761
2304,65457,60236,26657,61195,60280,26657,300482
5401,3075,2959,1841,1462,3535,1841,14713
2352,36345,57590,426,28137,69141,426,192065
2217,71674,173759,3425,85521,219306,3425,557110
2219,214961,419100,4672,163822,295443,4672,1102670
2145,32707,55523,1966,31126,56347,1966,179635
2220,76388,108302,893,101030,199840,893,487346
1215,357103,557756,36473,335915,539835,36473,1863555
4515,42056,38339,59,5811,29536,59,115860
1127,1595130,3890370,204766,1650077,3875771,204766,11420880
7835,17311,13278,1025,15959,13288,1025,61886
9940,100289,64103,40150,135982,64104,3525,408153
6800,131709,241502,327157,115943,252141,327157,1395609
5402,1115,4175,4481,1559,4489,4481,20300
9620,78975,72429,48715,86438,72418,48715,407690
5945,4944,5040,3835,5920,5387,3835,28961
2737,124589,215558,67683,137394,216851,67683,829758
5095,149398,302501,596994,72414,338814,596994,2057115
2739,129513,664639,31013,125187,660655,31013,1642020
2738,6526,6776,159,5324,6556,159,25500
2740,10290,21205,1233,10928,21700,1233,66589
2732,13344,11739,22222,13275,13836,22222,96638
5625,36520,52764,40416,38978,57612,40416,266706
2450,15351,4317,274,15091,4314,274,39621
8750,3006,2107,47,3395,2108,47,10710
9760,71525,45671,111529,70611,45670,111529,456535
1176,35326,24282,24477,34625,24319,24477,167506
4574,11002,1727,9028,12811,1726,9028,45322
9716,48783,35841,16805,46488,35837,16805,200559
7503,1260,692,68,754,629,68,3471
6204,3396,102,341,3099,114,341,7393
1360,34144,121065,178730,31288,122467,178730,666424
1141,2882,4921,5,3871,4919,5,16603
2123,73286,103084,1403,65809,117700,1403,362685
1282,14384,5747,3303,14464,5770,3303,46971
3501,16942,45024,2635,17675,44517,2635,129428
2435,755,563,378,568,570,378,3212
5253,32434,210838,85498,30760,215857,85498,660885
9668,4503,1499,2525,6242,1499,2525,18793
7740,17509,18503,656,22335,10849,656,70508
2599,185324,507035,87588,194276,514055,87588,1575866
8536,6646,14159,2366,5585,14133,2366,45255
5626,14767,27080,40569,12575,34835,40569,170395
1993,4025,352,3080,3794,355,3080,14686
2195,37315,73188,590,44019,92310,590,248012
2239,31598,38991,1723,35931,38801,1723,148767
4513,49,383,5,102,386,5,930
5130,22891,74206,91267,19054,80219,91267,378904
4304,10356,5149,300,11076,5274,300,32455
5254,5323,8940,16819,5834,9724,16819,63459
6216,37993,21591,7072,38137,21445,7072,133310
5894,6941,7958,12211,6476,10588,12211,56385
6237,8448,468,2266,8872,478,2266,22798
3018,27473,40223,39652,25105,43182,39652,215287
5876,148914,529555,166528,145193,533465,166528,1690183
1112,50231,62459,2036,52777,62443,2036,231982
1381,2369,3449,6233,2609,4126,6233,25019
6027,12815,7190,47996,9576,7330,47996,132903
9968,7570,4512,59314,9464,4513,59314,144687
5403,2693,10923,7660,2617,12402,7660,43955
5693,205587,257691,188998,205011,266494,188998,1312779
8346,120250,59863,7715,12137,39113,7715,246793
8345,354777,525146,29650,443445,535835,29650,1918503
3341,26567,41109,24753,29640,41135,24753,187957
5530,22420,1190,7202,23957,1135,7202,63106
6801,19780,94627,135132,17238,101673,135132,503582
2944,24660,39611,22470,22785,43616,22470,175612
5500,16881,39672,35803,16871,44398,35803,189428
8496,26004,15010,4042,29627,13976,4042,92701
7565,1097,1518,304,1592,1517,304,6332
7259,1058,450,15,1129,450,15,3117
9938,14321,11989,3525,15301,11991,70159,127286
7200,2910,3343,483,3346,3358,483,13923
5875,19786,27066,18602,21823,28079,18602,133958
2045,713,71,0,715,71,0,1570
2779,12611,23187,7354,12895,24279,7354,87680
9251,64,3,0,66,3,0,136
5552,23673,27635,8936,30963,33161,8936,133304
6872,191192,230598,529693,160384,244966,529693,1886526
1560,5114,13515,7485,3727,16434,7485,53760
9889,27278,11684,11805,34428,11688,11805,108688
8823,1470,579,0,1494,583,0,4126
3809,80747,191420,37368,86640,191255,37368,624798
9789,45518,28900,10580,40819,28901,10580,165298
3449,20721,34596,4827,20306,34799,4827,120076
8049,47037,83091,29945,47276,83140,29945,320434
2554,3524,3728,2410,3281,3741,2410,19094
6464,70,22,0,79,23,0,194
5268,375380,2368533,954878,329876,2392647,954878,7376192
6601,1,3,0,1,3,0,8
6810,25535,19911,55167,25292,20243,55167,201315
2603,7393,17999,3652,6354,18103,3652,57153
3230,181244,233291,80380,178276,231141,80380,984712
3231,508785,1019057,322448,502065,1013750,322448,3688553
4012,2053,6848,1544,2043,6847,1544,20879
4187,6577,8312,1389,7102,8370,1389,33139
5081,9578,24715,22709,15412,26335,22709,121458
2240,29714,42982,1596,28293,43572,1596,147753
1018,5132,4469,20,5117,4472,20,19230
2892,15570,22273,8720,13355,23968,8720,92606
5006,20753,89564,82745,20499,91821,82745,388127
5886,44001,136949,208663,40796,138429,208663,777501
8429,8781,6433,546,8638,6463,546,31407
5404,84222,135319,288566,51178,139402,288566,987253
2190,55571,79462,706,55846,94679,706,286970
2191,22085,37079,88,17799,30254,88,107393
2697,21699,34056,16980,18441,37044,16980,145200
5096,22267,33117,107365,13889,43610,107365,327613
5064,249749,897540,833199,208973,910542,833199,3933202
4715,16393,14525,5045,16025,18005,5045,75038
1437,24151,34673,20836,18472,34285,20836,153253
1438,8909,13958,6918,6384,14116,6918,57203
6074,12554,10771,33772,11633,10877,33772,113379
5687,65272,92004,140803,62234,100807,140803,601923
4175,344,293,240,413,319,240,1849
8050,872,198,587,682,198,587,3124
8618,1500,640,0,1448,638,0,4226
8051,39750,34281,29810,40524,34323,29810,208498
9023,495,1085,1496,572,1082,1496,6226
6812,107257,132418,337829,97163,132648,337829,1145144
6958,12026,10702,32351,15534,10769,32351,113733
7289,7154,9113,1461,7583,10250,1461,37022
7006,1550,807,311,1482,931,311,5392
3623,1464,1816,23,1504,1736,23,6566
5702,2085,4672,477,2141,4716,477,14568
2222,11294,10246,1762,11746,10319,1762,47129
7290,4,8,0,10,8,0,30
2422,10620,1503,176,12483,1513,176,26471
4182,1114,1148,465,1119,1133,465,5444
3502,215,247,0,274,247,0,983
4317,1914,1247,0,1949,1277,0,6387
1865,30386,25799,5376,27697,25778,5376,120412
7085,1583,5518,11710,1560,5801,11710,37882
5483,53016,178443,387142,58651,184354,387142,1248748
8565,47887,47784,1323,55387,47158,1323,200862
8500,72416,37048,7334,78244,35895,7334,238271
2945,11019,19004,5657,9673,20764,5657,71774
1975,2794,1068,358,2648,1069,358,8295
3176,75557,105236,106010,76122,117149,106010,586084
6873,8612,38428,86388,7956,40579,86388,268351
2743,82,232,286,260,249,286,1395
2550,18985,33773,6803,21012,33683,6803,121059
2549,21079,27595,9881,22920,27566,9881,118922
9767,55170,34810,25580,62270,34812,25580,238222
9107,12924,19128,13941,14103,19097,13941,93134
2279,20577,23336,3714,18110,23681,3714,93132
2280,6000,9281,1146,5728,10509,1146,33810
5927,4533,6481,4723,5304,6826,4723,32590
6200,2986,804,274,2280,822,274,7440
1658,47323,94914,24124,49267,95404,24124,335156
2623,0,1,0,0,1,0,2
7008,35933,38659,6410,39974,39190,6410,166576
9791,22019,16060,10116,23435,16062,10116,97808
6913,52796,48373,145833,30558,48311,145833,471704
1395,28853,38908,101066,19059,41908,101066,330860
1179,23937,18800,1657,20552,18834,1657,85437
5324,2783,6437,9730,2641,7320,9730,38641
2946,19885,85791,19623,16987,86146,19623,248055
5689,26679,35713,53398,29501,39330,53398,238019
4124,178,160,0,209,156,0,703
3811,36020,55791,31616,39211,55796,31616,250050
2536,12943,743,26,13627,744,26,28109
3812,58524,145774,56408,64680,145833,56408,527627
4412,4380,5728,142,4506,5835,142,20733
3680,8667,11460,3673,10532,11473,3673,49478
1439,6682,9436,1888,10068,11001,1888,40963
3562,5418,4443,1756,5442,4452,1756,23267
3238,10679,14867,4598,11553,14920,4598,61215
5682,49078,92416,43392,46483,101511,43392,376272
3504,23065,28139,1552,22337,28456,1552,105101
7022,384608,1116531,464128,337040,1142822,464128,3909257
6962,442,86,124,2855,92,124,3723
9768,92731,63699,47504,100532,63693,47504,415663
1440,25389,44119,26176,34390,42912,26176,199162
9878,8691,6300,7209,9753,6311,7209,45473
1129,8661,9765,918,8560,9791,918,38613
6963,1470,2127,3478,10705,2440,3478,23698
1016,14236,28307,36,15734,28440,36,86789
1441,10267,10819,7896,11084,12130,7896,60092
5164,26672,138013,43946,18579,92541,43946,363697
5007,129147,414842,257275,137036,448505,257275,1644080
7292,3198,2138,723,3555,2136,723,12473
2186,11845,5668,3156,16431,5676,3156,45932
3542,10819,10176,207,12834,10541,207,44784
9112,5222,4169,1952,4141,4171,1952,21607
3815,14618,14548,18047,13879,14548,18047,93687
3899,712631,1852879,376631,690890,1849253,376631,5858915
3900,162542,264650,153223,130418,264600,153223,1128656
9624,18384,10556,8193,21330,10557,8193,77213
9969,24842,19574,40990,28061,19574,40990,174031
9877,8094,6769,1233,9166,6769,1233,33264
1964,11259,7588,3136,11271,7598,3136,43988
2118,140691,277564,46743,138031,277222,46743,926994
6201,5931,2861,2038,5589,3189,2038,21646
9702,31804,27073,24329,33650,27077,24329,168262
4068,37659,73756,13311,36837,73705,13311,248579
9769,14988,10854,3263,18337,10854,3263,61559
2640,19822,28225,6624,20599,28270,6624,110164
9028,5638,4927,3379,5200,4934,3379,27457
9897,36108,17885,8126,39128,17885,8126,127258
1442,34206,87938,61630,18821,99784,61630,364009
8621,603,448,61,746,446,61,2365
5405,44518,68675,147189,28314,78261,147189,514146
5406,38225,60682,130006,31577,61420,130006,451916
9704,1757,1200,858,1741,1204,858,7618
9680,14387,11369,5989,14915,11456,5989,64105
3098,3705,5235,3590,1789,5842,3590,23751
5703,16393,42807,3244,15624,42729,3244,124041
8359,44981,61309,1916,49062,57709,1916,216893
2919,9918,14497,5415,10463,15627,5415,61335
7914,1259,1539,9983,1218,1540,9983,25522
5351,30473,87199,99613,29791,92911,99613,439600
5077,44001,81128,161636,38460,116907,161636,603768
5047,48551,109621,306883,16782,96691,306883,885411
3820,33878,38868,34401,36621,38887,34401,217056
9795,69698,39259,29715,71948,39258,29715,279593
8232,6472,4558,3836,6981,4558,3836,30241
3568,771,353,0,821,353,0,2298
2425,4707,213,149,5116,213,149,10547
6874,89214,94524,389098,62912,104963,389098,1129809
7447,16122,62027,39131,22304,64084,39131,242799
7469,32994,65332,221791,27855,70499,221791,640262
2762,4372,14268,986,4416,14991,986,40019
5820,122,113,153,161,116,153,818
6664,28201,38288,7354,30241,36659,7354,148097
7051,939,4127,4693,966,4150,4693,19568
5097,4584,9794,9131,3804,12282,9131,48726
9911,293672,218743,241676,322549,218746,241676,1537062
3004,25336,56669,24843,25377,59075,24843,216143
5144,62153,149907,235383,32866,156120,235383,871812
5008,5812,6529,3230,7210,7505,3230,33516
2947,4177,3316,1724,3169,4669,1724,18779
5199,158502,401203,657689,145781,419310,657689,2440174
7792,288,152,217,388,155,217,1417
2870,65489,113137,44470,63049,117521,44470,448136
5352,41945,67458,143951,32384,72349,143951,502038
1372,4204,10879,21364,2857,15272,21364,75940
2764,4874,6526,1312,5819,6533,1312,26376
6836,228665,720218,1438795,188939,772904,1438795,4788316
5098,29369,20092,217292,17924,26194,217292,528163
4731,82449,248043,33214,86363,248105,33214,731388
3774,12907,23566,6194,15189,23816,6194,87866
2573,5232,5014,2399,5672,4996,2399,25712
5553,29024,42702,116760,34257,43748,116760,383251
6814,100446,101645,280261,88304,101964,280261,952881
5582,19824,37707,50960,9917,38201,50960,207569
5554,15544,59741,18812,14948,63295,18812,191152
2412,244884,649682,80313,229363,651551,80313,1936106
7736,21831,4977,6643,22679,4985,6643,67758
1130,45179,45756,2091,45907,45744,2091,186768
6615,124159,231171,47075,131212,231264,47075,811956
5200,6314,11758,34503,6359,13245,34503,106682
5840,356,482,0,568,484,0,1890
5255,128447,376325,202232,123445,369747,202232,1402428
5009,2275,5643,2582,2016,7109,2582,22207
5296,2128,1476,3620,2297,1664,3620,14805
6914,73699,96217,266431,61817,96827,266431,861422
2823,7685,10956,3010,8854,10951,3010,44466
3267,120777,210781,138661,122736,213819,138661,945435
5353,5129,4707,21781,3099,6282,21781,62779
4449,5137,9623,1336,6166,9669,1336,33267
5099,71104,86228,203749,39590,100365,203749,704785
5583,38355,27695,23616,36386,28893,23616,178561
3031,18581,30751,45949,21921,32193,45949,195344
2745,102508,69594,48050,103969,71024,48050,443195
5879,32472,78890,92185,32051,80164,92185,407947
5319,4052,12879,17791,3605,13987,17791,70105
2556,6745,4403,2371,7180,4419,2371,27489
8233,10550,1929,6001,11012,1931,6001,37424
4365,12415,22175,9621,13018,22238,9621,89088
3785,164,156,0,177,173,0,670
5121,243913,1636023,3820091,337343,1590871,3820091,11448332
6850,16020,157283,96980,18101,161384,96980,546748
5555,13521,19602,38122,7507,25906,38122,142780
5301,2244,2768,4454,3342,4539,4454,21801
5595,723903,1275759,1658451,661309,1323093,1658451,7300966
2653,2505,646,191,2325,645,191,6503
6926,28219,60573,117414,19836,64733,117414,408189
4069,1066,1155,421,1091,1157,421,5311
9792,81275,60365,51570,83654,60369,51570,388803
4593,1148,217,179,1185,208,179,3116
5556,35119,60606,108034,25619,74489,108034,411901
6274,31192,47084,1440,31782,47279,1440,160217
9718,8835,6511,1393,10822,6511,1393,35465
3202,34539,3648,6449,39048,3653,6449,93786
2795,74,20,247,127,32,247,747
2574,25576,49228,5483,19341,49758,5483,154869
5048,37746,53656,167667,21359,66470,167667,514565
4070,1391,1675,41,1494,1675,41,6317
9855,63084,60493,71258,73355,60500,71258,399948
9747,10614,6979,1529,16726,6985,1529,44362
9752,63209,51018,29561,64063,51017,29561,288429
9762,40672,27878,15569,37710,27879,15569,165277
5557,41225,72569,112982,30702,90995,112982,461455
4616,5379,5065,10638,5622,5093,10638,42435
3828,15848,25652,15612,19621,25649,15612,117994
6861,102776,621925,820265,102639,641292,820265,3109162
6853,10453,37184,21966,1865,30662,21966,124096
6349,6856,317,988,7242,313,988,16704
5457,6578,11825,8037,7816,13448,8037,55741
2562,10115,15273,4036,9813,15321,4036,58594
4876,8087,7463,3486,9855,7620,3486,39997
2451,28210,87225,11525,25811,87109,11525,251405
3005,360,50,238,405,52,238,1343
7515,408,765,720,537,765,720,3915
1227,21061,14922,11195,22772,14941,11195,96086
6488,6340,12825,1818,6332,12338,1818,41471
8708,716,857,234,1027,859,234,3927
8470,20003,3360,7289,20961,3341,7289,62243
2486,2004,3772,338,2778,3880,338,13110
5458,7731,23046,11580,7378,23917,11580,85232
3019,15950,28295,35222,18915,31291,35222,164895
5336,1007,1257,9249,880,1597,9249,23239
3570,11,39,0,38,39,0,127
5821,203,87,653,274,84,653,1954
7504,7948,13085,1961,11045,13097,1961,49097
1847,29,274,0,66,273,0,642
2049,2148,302,2866,2380,303,2866,10865
8824,668,94,0,611,95,0,1468
8825,3351,1275,0,4629,1275,0,10530
3905,15400,25410,11552,14044,25403,11552,103361
1143,15909,23604,136,16954,23647,136,80386
4617,9476,13703,2036,9514,13921,2036,50686
5896,76607,123243,49866,74725,121352,49866,495659
8056,36249,42023,39743,39805,42031,39743,239594
8505,6438,3137,1014,6634,2638,1014,20875
5408,42943,93863,205412,30760,113337,205412,691727
1030,316760,657991,81603,317893,654687,81603,2110537
5409,319,1080,1955,301,1683,1955,7293
9185,14987,20468,6767,16457,20490,6767,85936
4639,38049,52901,7839,36362,55126,7839,198116
9970,14922,15491,34964,14364,16095,34964,130800
7579,8794,1573,2381,7973,1580,2381,24682
3634,7770,13081,2933,8210,13147,2933,48074
5484,71288,301385,165801,74125,302472,165801,1080872
5100,35872,58918,276765,23806,66405,276765,738531
5754,5234,7293,2208,6217,7307,2208,30467
6837,192,2016,12372,1487,3359,12372,31798
2225,19073,29522,490,19045,29961,490,98581
1243,221498,389293,96863,209100,389903,96863,1403520
5832,4382,32596,1056,4625,32977,1056,76692
6007,1923,4270,1400,6506,4256,1400,19755
8826,3647,1895,0,3475,1897,0,10914
4312,3184,4932,314,2879,5125,314,16748
1519,19666,58223,76261,11018,64219,76261,305648
9778,32113,20999,27112,29717,20999,27112,158052
5078,24094,33687,93288,11066,39793,93288,295216
7295,13191,18936,189,14880,19006,189,66391
1822,4289,4264,87,4470,4272,87,17469
8473,85666,44709,12783,81575,41460,12783,278976
8554,25859,23407,3076,30535,22018,3076,107971
9814,38996,24265,122691,45136,24268,122691,378047
9796,56335,28992,31746,60029,28991,31746,237839
2313,9375,11959,705,9926,11963,705,44633
7406,10589,5842,4004,10086,6019,4004,40544
5325,6797,14224,29167,5174,15928,29167,100457
5233,1479,5794,9006,1530,6728,9006,33543
6524,4019,3098,729,3240,3099,729,14914
5628,26122,36620,43396,34694,38435,43396,222663
1396,26,99,495,53,171,495,1339
9943,52109,35953,32589,54651,35959,40150,251411
2876,3,1,0,7,1,0,12
5356,51039,115525,134244,30201,129359,134244,594612
2305,9267,10459,1635,10271,10467,1635,43734
6008,43299,47518,150790,37277,47755,150790,477429
3107,2658,1593,4430,3034,1672,4430,17817
8625,694,359,0,648,360,0,2061
9721,42207,28640,15618,45598,28652,15618,176333
9121,16786,30682,6640,18666,30711,6640,110125
9218,10722,4484,5363,8994,4483,5363,39409
6964,2938,5557,11821,2478,8098,11821,42713
5201,7025,11804,8051,6277,14297,8051,55505
3981,3789,6423,1402,3422,6421,1402,22859
3738,20728,39215,8175,23252,39281,8175,138826
4147,423,513,0,551,638,0,2125
7440,7929,3796,15030,9558,3795,15030,55138
2777,12995,19851,10494,10505,22073,10494,86412
9135,145,197,966,138,196,966,2608
8711,516,414,5,588,417,5,1945
9790,17152,10092,3274,16804,10092,3274,60688
9415,41170,19358,40652,46341,19360,40652,207533
9992,141743,77402,31828,159678,77402,31828,519881
9864,48269,31727,77372,42263,31727,77372,308730
9483,23684,18228,17854,27673,18231,17854,123524
2077,6112,99,922,6304,101,922,14460
1429,36298,77873,118493,23842,77243,118493,452242
1957,3808,4710,943,3918,4710,943,19032
8628,576,363,0,779,362,0,2080
7915,1340,2543,5141,1517,2550,5141,18232
3797,6432,6656,4343,6658,6658,4343,35090
4519,1275,1167,5,1377,1276,5,5105
7877,262655,354051,81190,260886,353735,81190,1393707
6729,894,652,729,854,657,729,4515
7211,3528,6257,114,4089,6274,114,20376
5101,142388,419078,545655,135718,418786,545655,2207280
8420,15573,21055,4285,15231,20902,4285,81331
2576,15309,30844,5373,18091,31634,5373,106624
5668,19077,35961,33594,19957,41431,33594,183614
2770,19900,26063,15898,18089,28545,15898,124393
3408,24437,58502,55010,24050,58512,55010,275521
3409,2864,17857,1624,5670,17856,1624,47495
5011,26368,84433,77477,24143,87985,77477,377883
2877,2816,7019,2705,2945,8215,2705,26405
5942,1469,1023,528,1631,1036,528,6215
2963,2713,8258,2350,3042,6428,2350,25141
5412,812,1432,6391,782,1330,6391,17138
2480,2624,506,2338,3162,559,2338,11527
8441,6814,4682,391,5990,3356,391,21624
2306,2334,5261,400,2750,5267,400,16412
8432,7146,10978,1644,8809,10964,1644,41185
3052,11963,26956,18782,10206,27024,18782,113713
3060,1454,2476,3060,2420,2480,3060,14950
5421,62059,157349,264347,55286,152635,264347,956023
2103,3487,1209,0,3707,1219,0,9622
2855,8,85,0,13,86,0,192
5145,25935,51063,63660,22003,51439,63660,277760
1823,315006,565987,115107,317631,563966,115107,1992804
7212,2511,4801,369,2634,4809,369,15493
2652,3285,5886,1506,2928,6413,1506,21524
3579,10712,4092,3488,12304,4105,3488,38189
8326,115418,144678,8845,112970,150775,8845,541531
3030,156013,310203,350617,154206,315168,350617,1636824
5753,10193,5905,8101,10180,5906,8101,48386
5502,1971,1681,1353,2107,1679,1353,10144
3901,5107,12488,3325,5336,12478,3325,42059
3830,16476,31427,12362,21000,31438,12362,125065
3861,2037,4379,815,2636,4381,815,15063
8632,9698,3096,190,5768,3093,190,22035
7897,3182,1347,2117,2798,1347,2117,12908
2893,9304,8279,7052,7913,9143,7052,48743
2765,10038,19601,866,9329,19932,866,60632
7348,26401,84550,28272,29349,85379,28272,282223
2289,3,0,0,3,0,0,6
3588,1749,988,324,1632,988,324,6005
6781,2128,5254,807,2146,5295,807,16437
4188,385,257,0,348,277,0,1267
5036,100,542,630,149,660,630,2711
2538,523,19,0,538,20,0,1100
2452,4850,294,1407,4824,298,1407,13080
6417,366035,578609,151997,368312,583480,151997,2200430
5961,39329,138969,42224,37706,138472,42224,438924
5962,20,73,0,29,71,0,193
6690,11927,6805,2265,11341,6835,2265,41438
5357,89612,214320,211695,86183,226178,211695,1039683
5297,48,99,264,51,91,264,817
5413,3146,7807,32012,1969,10341,32012,87287
4525,34881,56707,7818,32708,57685,7818,197617
2766,879,3103,493,1727,3169,493,9864
5033,80048,278090,81022,81806,263651,81022,865639
6901,4013,27602,21529,3782,27331,21529,105786
4436,496,189,5,613,196,5,1504
7055,18195,48557,21419,19605,50173,21419,179368
3099,2179,2571,2000,1801,2302,2000,12853
6000,19348,4876,11827,9190,4788,11827,61856
9317,14267,6053,7926,17091,6055,7926,59318
8057,25645,30612,23807,27493,30612,23807,161976
1994,1021,386,233,988,393,233,3254
4878,74570,27768,35090,82572,27450,35090,282540
6616,5660,533,1125,4554,530,1125,13527
9994,74072,42897,16118,77552,42897,16118,269654
9757,25522,17297,12135,26399,17296,12135,110784
9993,45726,32906,11308,42179,32905,11308,176332
1040,13998,9381,1712,13713,9398,1712,49914
1212,17724,23588,1359,17677,23471,1359,85178
1691,6594,3133,1093,6246,3147,1093,21306
8681,70,46,0,117,46,0,279
9906,4497,1528,1222,5219,1528,1222,15216
7027,2875,227,2199,3426,229,2199,11155
9866,120057,97133,28083,139437,97111,28083,509904
9868,67321,42614,11028,73768,42619,11028,248378
9622,18834,13709,4360,24765,13707,4360,79735
9490,12312,59619,2671,13094,59399,2671,149766
5034,2305,4891,2103,2683,5707,2103,19792
9397,11322,43525,28442,11036,46781,28442,169548
8713,67807,56032,29562,68650,56037,29562,307650
5944,2026,1884,729,2293,1976,729,9637
8682,93,54,0,124,54,0,325
9039,107391,318641,57571,106294,317882,57571,965350
9186,59640,58335,74484,65465,58328,74484,390736
8763,2088,3121,237,2570,3130,237,11383
9492,10681,10452,6036,12024,10445,6036,55674
8642,84,23,0,265,23,0,395
7744,21,26,0,78,21,0,146
5102,1142,1271,8143,1699,3062,8143,23460
7745,151520,375244,63968,160461,374734,63968,1189895
5282,36638,75515,90187,36780,75758,90187,405065
8905,77933,22078,13865,78384,22078,13865,228203
4455,2193,2966,1210,2456,3128,1210,13163
7916,8897,6342,7537,11016,6351,7537,47680
3190,112552,846689,1177786,105033,840112,1177786,4259958
2292,29855,42439,8957,28845,42440,8957,161493
5694,46714,48567,49962,46110,49403,49962,290718
5584,161753,252856,441865,89663,270630,441865,1658632
5414,6650,4128,33284,5603,7356,33284,90305
4520,3454,9654,15964,3606,9648,15964,58290
7746,26291,31112,1231,36184,16909,1231,112958
5355,814395,2233357,2290832,885903,2249114,2290832,10764433
2949,14633,20326,8261,14375,22037,8261,87893
5358,25328,43879,106021,13739,50666,106021,345654
5234,2191,3347,899,2457,3548,899,13341
8472,49223,22113,4316,41798,21511,4316,143277
5486,42644,168740,194797,31587,179752,194797,812317
9793,118985,83422,31043,120290,83448,31043,468231
5134,5296,12997,16116,4511,18733,16116,73769
7471,24997,36009,64947,26730,37664,64947,255294
5283,12597,22987,78187,22124,25719,78187,239801
5448,102404,575149,235352,96561,580456,235352,1825274
3795,19388,31687,12638,20865,31682,12638,128898
9894,48915,23858,24142,47506,23858,24142,192421
2128,21366,30878,387,13819,26910,387,93747
5899,100619,176202,138807,96166,178159,138807,828760
8114,438,63,291,486,63,291,1632
2950,12158,22054,8970,11680,24553,8970,88385
7370,288,222,228,344,222,228,1532
2227,5909,8770,191,5444,9043,191,29548
2824,8059,15205,324,9111,15268,324,48291
5056,22690,26044,78123,15507,31216,78123,251703
5473,15100,38947,23603,16953,48394,23603,166600
5359,6290,9707,33227,3506,9124,33227,95081
2169,8169,9222,323,10054,10461,323,38552
9328,1459574,2400453,986445,1474304,2380878,986445,9688099
5642,26096,35531,60538,14677,47221,60538,244601
5822,2113,3928,9714,2646,3932,9714,32047
5669,96852,267993,185652,94146,272830,185652,1103125
7918,1126,1010,7071,1271,1010,7071,18559
5246,33724,57810,40706,54482,46155,40706,273583
8977,34425,32838,6638,36013,32862,6638,149414
2121,44192,33247,7794,56133,33428,7794,182588
5049,27134,34398,154986,15890,42281,154986,429675
5135,50372,72830,226664,29882,82969,226664,689381
7349,5903,1192,419,5534,1197,419,14664
6667,19943,35184,5363,20298,34421,5363,120572
6832,14472,19510,64629,12835,23951,64629,200026
1542,67516,243091,308381,59877,258421,308381,1245667
5103,119831,188561,459953,69376,215304,459953,1512978
6238,57,3,0,56,3,0,119
7068,87169,124034,72631,88688,125554,72631,570707
7473,856,1041,2474,4685,1155,2474,12685
5257,23821,38656,26574,24670,42059,26574,182354
6010,52014,58156,192349,20543,56789,192349,572200
6815,25034,24730,64578,26465,24947,64578,230332
6959,94282,120677,213576,81887,122081,213576,846079
2747,1296,3100,206,1105,3132,206,9045
5360,197050,396197,426707,195307,412317,426707,2054285
5361,1775,4491,5464,1189,6492,5464,24875
1041,50378,51287,5087,51855,51349,5087,215043
5459,1965,2389,4555,1273,3365,4555,18102
5104,30543,49747,112204,17212,54441,112204,376351
5558,61759,101321,123615,60452,101446,123615,572208
6004,20552,7635,32408,14465,7365,32408,114833
5217,9142,26775,57122,7245,30249,57122,187655
1294,3763,783,876,4225,801,876,11324
2080,2992,950,311,3310,966,311,8840
4740,24622,53334,14183,25180,53596,14183,185098
5415,29392,43942,81332,34018,45532,81332,315548
5586,46451,69347,149198,32868,80530,149198,527592
5755,81279,225771,180016,75065,219231,180016,961378
3410,136064,445746,108982,135340,447302,108982,1382416
3414,5683,7596,3441,5380,7597,3441,33138
9914,62085,77985,14214,60666,79232,14214,308396
5756,53097,148328,66779,58826,149537,66779,543346
5760,1693,2506,1064,1967,2505,1064,10799
5065,8829,12715,23765,4736,18010,23765,91820
2951,7655,13830,2952,8128,15785,2952,51302
4416,8464,9404,2170,8068,9278,2170,39554
2780,1087,905,944,1247,1193,944,6320
9452,7847,4188,2121,8990,4197,2121,29464
3873,2396,3255,2841,2734,3257,2841,17324
5137,45854,52286,193520,25976,62278,193520,573434
9930,125261,125965,88859,166421,126045,88859,721410
9931,44408,72852,74849,23223,72671,88859,376862
8726,45,16,0,19,16,0,96
5337,58992,244395,45821,56610,238107,45821,689746
3508,3565,8585,5,4486,8409,5,25055
3591,14109,20247,26,15258,20600,26,70266
6875,2254,5551,38849,2464,6178,38849,94145
5900,123263,211738,133156,124088,214914,133156,940315
5521,189718,288829,386580,183502,300324,386580,1735533
5688,246,363,1358,268,364,1358,3957
5643,61481,70631,92782,56428,72855,92782,446959
5545,90443,195151,200833,86193,206905,200833,980358
5105,10630,21359,57400,7228,26852,57400,180869
2811,3069,6265,573,2751,6835,573,20066
9245,7730,5224,1351,8389,5223,1351,29268
5167,68734,191397,301307,62960,196632,301307,1122337
5493,330,328,261,482,357,261,2019
2126,36889,63362,972,41264,72293,972,215752
8637,243,176,0,227,176,0,822
8544,11258,11694,0,10990,10631,0,44573
7214,16472,31830,4739,17341,32216,4739,107337
5559,89146,190615,146822,81563,197076,146822,852044
5808,5602,13411,9214,5877,12616,9214,55934
1377,2395,6828,4682,2956,6851,4682,28394
3862,3196,5847,1399,2863,5847,1399,20551
8061,19194,1465,5132,21582,1466,5132,53971
4074,2661,2847,1690,2984,2848,1690,14720
4066,420,468,0,450,475,0,1813
8062,17249,34638,7717,19003,34639,7717,120963
3235,59345,17061,109915,59302,16855,109915,372393
1445,11297,19991,8293,14651,20253,8293,82778
6119,143655,385390,697100,145109,371636,697100,2439990
3012,599,65,79,792,68,79,1682
5261,3176,7114,6310,5136,7750,6310,35796
5284,7479,19530,9843,16682,21670,9843,85047
4076,2839,9923,0,3212,9902,0,25876
6351,1843,241,239,1926,244,239,4732
8583,19984,25497,1038,21139,23360,1038,92056
4503,86281,59799,5400,92380,59072,5400,308332
5522,79452,144453,256584,75278,154091,256584,966442
2026,4268,889,775,4206,889,775,11802
2513,23624,47973,10322,22351,48175,10322,162767
1532,37731,123768,211841,28661,140501,211841,754343
2935,6267,11197,5643,4675,12855,5643,46280
2786,12978,17938,8690,13212,20546,8690,82054
5035,57485,191497,140427,58007,198797,140427,786640
5027,7858,9282,20398,6516,8353,20398,72805
5258,5395,19658,6436,5100,19681,6436,62706
6876,57791,115664,245509,42299,114923,245509,821695
5362,114339,223377,462647,50933,244580,462647,1558523
2354,68746,115044,1411,62527,120027,1411,369166
8638,14831,9255,3369,15124,9274,3369,55222
8639,249,477,0,265,476,0,1467
9675,12303,8176,7409,11641,8396,7409,55334
8827,39026,14841,0,31139,14800,0,99806
1042,37206,45036,1016,35571,45048,1016,164893
2046,1151,4344,508,1277,4463,508,12251
7029,3525,5187,10910,5203,5912,10910,41647
5218,6123,6267,28512,5730,7825,28512,82969
5509,126278,206394,73543,118202,200078,73543,798038
2355,40975,66428,60,52058,84372,60,243953
3344,3472,3064,2184,4284,3067,2184,18255
5683,26621,37508,20574,25506,39064,20574,169847
6854,5787,37612,37757,5677,38616,37757,163206
8556,45886,19085,5038,37263,17444,5038,129754
2284,19444,14707,2998,22905,14732,2998,77784
5707,11717,15871,5874,12671,15955,5874,67962
5587,21457,30683,51426,12254,34033,51426,201279
2952,2824,6244,2731,3053,6225,2731,23808
3144,14031,15169,28427,15118,17145,28427,118317
6465,1,17,0,0,17,0,35
6424,17350,6152,3267,18962,6148,3267,55146
9971,878,513,5,1054,512,5,2967
8474,90801,40873,11067,78690,39822,11067,272320
2654,4112,703,399,4308,704,399,10625
9904,73423,45961,34910,71213,45960,34910,306377
9979,46017,24585,14423,45177,24587,14423,169212
2104,4634,1549,237,4831,1559,237,13047
1559,5818,12243,11885,2516,16794,11885,61141
2228,24556,46549,656,28775,61666,656,162858
2335,26629,22920,1799,26456,22913,1799,102516
4148,237,440,25,241,455,25,1423
3961,2032,3313,396,1723,3309,396,11169
8640,1607,329,0,964,320,0,3220
2397,5707,6801,3141,5420,6398,3141,30608
2953,19201,28850,12729,16592,31358,12729,121459
5416,2248876,1388159,212078,2205277,1206679,212078,7473147
8641,240,263,0,233,263,0,999
3051,86607,191746,142688,80803,191906,142688,836438
6877,94995,141876,537497,66366,151061,537497,1529292
9794,60470,51088,26650,66488,51090,26650,282436
2655,3790,961,468,4164,968,468,10819
8117,14076,11173,10026,15993,11172,10026,72466
4022,1651,3290,2588,1918,3291,2588,15326
5796,21205,75398,24461,19321,78076,24461,242922
5169,119511,293129,369164,113091,308725,369164,1572784
5363,52925,129629,238484,29389,138431,238484,827342
9501,18997,9891,5795,21635,9894,5795,72007
7921,1393,1445,10760,1740,1443,10760,27541
2454,2347,96,9707,2606,97,9707,24560
9813,4027378,4272004,1741137,4252785,4270539,1741137,20304980
9627,28560,18771,14027,28145,18771,14027,122301
9628,15086,11574,2680,16713,11573,2680,60306
9950,659117,355041,184985,109272,353769,32589,1694773
2301,5334,5728,4414,5432,6153,4414,31475
8715,3511,4536,552,4588,4650,552,18389
8828,1589,164,0,1621,162,0,3536
9503,44591,41189,24106,54026,41198,24106,229216
9301,5270,5787,3025,6248,5805,3025,29160
2895,51086,121950,40445,48918,120787,40445,423631
4760,88665,227409,33105,90079,226921,33105,699284
5338,1812,7361,3719,3275,8251,3719,28137
4457,16948,35289,3217,17530,35319,3217,111520
5629,79192,116015,208478,72736,128156,208478,813055
2948,4310,6453,3768,4656,7173,3768,30128
2954,0,1,0,0,1,0,2
5474,5848,11983,12230,4298,15204,12230,61793
8284,5371,10422,1153,5302,10473,1153,33874
9096,14,9,0,45,9,0,77
8643,1684,516,0,1891,515,0,4606
5298,1632,5023,2086,1369,5584,2086,17780
6878,55324,86930,338199,50371,88469,338199,957492
8025,31401,42595,15756,31724,42655,15756,179887
1220,4887,6128,817,5980,6146,817,24775
6028,38009,42459,150833,24976,42431,150833,449541
3033,31776,60342,74570,35380,63694,74570,340332
5272,17006,52076,80409,18833,54132,80409,302865
2962,10006,17766,4066,9287,19204,4066,64395
1409,30909,37899,19037,28126,36872,19037,171880
9635,79775,55289,22741,81723,55266,22741,317535
4131,1356,1362,148,1519,1357,148,5890
6206,10781,74,1792,10623,75,1792,25137
1965,24622,35434,5791,24701,35476,5791,131815
6029,19217,13258,38842,11706,13369,38842,135234
7972,1,2,0,0,2,0,5
3839,17890,17375,19090,20297,17385,19090,111127
6469,88461,138561,77037,93372,132999,77037,607467
5514,5389,6564,30754,4717,8060,30754,86238
1132,32274,35411,1807,32499,35426,1807,139224
5172,108313,331567,338406,83092,355337,338406,1555121
7443,149459,192796,546730,121169,207969,546730,1764853
7922,668,1777,0,751,1775,0,4971
6855,1967,20609,12000,1774,21329,12000,69679
7032,5141,4708,25950,8362,5435,25950,75546
6275,4424,8,542,3982,8,542,9506
4892,79058,47952,43833,79330,48287,43833,342293
1463,32830,53165,63624,32077,53352,63624,298672
8005,2,2,0,2,2,0,8
2218,38980,53814,880,53301,110012,880,257867
1996,1161,897,740,902,1069,740,5509
2325,20518,13758,4375,18076,13760,4375,74862
9725,13550,10114,3371,12513,10114,3371,53033
2900,11993,25250,6785,10814,26897,6785,88524
5138,14498,16716,62528,9636,21058,62528,186964
9681,47426,45814,14330,48734,45765,14330,216399
9682,86846,72652,33255,86510,72385,33255,384903
5146,113504,200554,284051,92734,200837,284051,1175731
9610,1273,3409,309,1990,3405,309,10695
6276,1444,61,495,2051,62,495,4608
6280,58840,93903,12025,59126,94397,12025,330316
2825,8219,6058,132,8694,6111,132,29346
8155,3233,4508,4577,2566,4511,4577,23972
5139,115074,161562,468145,55330,187377,468145,1455633
2955,15813,21408,13945,16800,21937,13945,103848
5631,396541,1319811,760432,391168,1302090,760432,4930474
8567,109551,97167,2128,99846,93022,2128,403842
5588,156692,141442,147926,55503,138116,147926,787605
3563,6766,7386,2309,7308,7384,2309,33462
7299,2057,1208,42,1900,1211,42,6460
4300,12919,1065,268,12688,1064,268,28272
7930,3841,453,76,3084,452,76,7982
6281,9065,3232,3479,9591,3384,3479,32230
5364,23169,49490,129394,14230,53507,129394,399184
6977,22933,40213,43906,16713,40655,43906,208326
6867,53869,55277,87948,44433,55173,87948,384648
6978,1785,2347,3539,5863,2926,3539,19999
3053,21362,36895,48535,21082,37099,48535,213508
7300,1161,483,33,1293,487,33,3490
2896,28540,60928,21659,22126,65547,21659,220459
6075,15426,14894,36814,15306,15188,36814,134442
2585,4731,9550,2979,3611,9809,2979,33659
4577,28883,9953,52209,27468,10003,52209,180725
9810,48468,30863,14016,43924,30860,14016,182147
2845,15884,12761,6565,14211,13453,6565,69439
7266,13442,4691,819,14075,4689,819,38535
2295,9595,7944,1487,7887,8817,1487,37217
8411,140983,202875,6934,143203,202737,6934,703666
4521,22344,26388,475,23195,26531,475,99408
2572,5088,6176,4103,4480,7188,4103,31138
2229,9018,17177,144,9028,19002,144,54513
5173,7229,11949,7916,6773,14052,7916,55835
7568,9018,12563,5199,10175,12565,5199,54719
5037,3890,7473,14814,4096,10137,14814,55224
5947,4984,4919,4702,5323,6056,4702,30686
9726,121530,96185,35282,139422,96092,35282,523793
9727,76296,50567,36137,65700,50563,36137,315400
8241,4579,3947,2422,5099,3950,2422,22419
5450,35475,61566,46493,39584,63010,46493,292621
1413,27885,54217,17012,30461,50792,17012,197379
5561,53038,218643,123124,31974,217178,123124,767081
1033,10289,9647,227,10325,9674,227,40389
5560,39394,89988,121921,22673,95185,121921,491082
5589,38193,56582,72351,25894,60024,72351,325395
1145,17978,21353,342,19283,21324,342,80622
5940,11671,17284,11641,11894,17905,11641,82036
3007,10542,9205,3636,11506,9421,3636,47946
2767,34875,32030,19678,39957,32029,19678,178247
3191,18456,23722,48616,11532,26240,48616,177182
2557,3469,3689,808,3755,3688,808,16217
4458,5761,8477,36486,5381,8462,36486,101053
1521,38097,79983,71626,23360,75468,71626,360160
7374,820,555,341,785,553,341,3395
1533,14243,40424,56189,11515,44578,56189,223138
6804,15460,12062,33713,15239,14007,33713,124194
6827,137568,210753,237119,123910,223687,237119,1170156
6879,96509,147018,441098,91821,154179,441098,1371723
1543,84166,289529,524276,67572,319781,524276,1809600
5140,3764,6373,12181,3235,7647,12181,45381
6012,39538,30225,73376,17746,30500,73376,264761
7401,9767,5099,2738,9226,5340,2738,34908
2027,5336,1741,2309,5418,1737,2309,18850
8213,180551,237354,83451,188777,237316,83451,1010900
1397,98864,243715,235575,71510,248352,235575,1133591
2230,14800,33629,4136,15317,33799,4136,105817
4579,2204,228,4238,3170,358,4238,14436
8009,43196,52652,15049,46074,52671,15049,224691
9246,3457,2153,587,3184,2157,587,12125
6902,5989,37753,16604,9690,38227,16604,124867
6905,989,8569,4347,1821,10578,4347,30651
5633,85440,201999,310714,77522,221908,310714,1208297
5489,30493,117761,234755,25925,130677,234755,774366
5219,73437,342464,103263,67249,346792,103263,1036468
1398,19993,58852,34154,19852,67997,34154,235002
6070,108346,200632,160563,96126,211910,160563,938140
6845,10090,28387,129144,8892,30700,129144,336357
2826,11625,8812,118,9658,8737,118,39068
2604,5300,8957,3107,5346,9433,3107,35250
4594,6169,2707,1191,7522,2888,1191,21668
5532,170922,360261,193633,159035,369828,193633,1447312
6260,76,3,0,79,6,0,164
4079,13279,33998,1847,13246,33772,1847,97989
2428,9484,1475,549,10079,1480,549,23616
2146,541,5,31,648,5,31,1261
9634,18152,14358,4176,17166,14357,4176,72385
7569,4718,3236,2510,4011,3238,2510,20223
5289,9434,8343,36015,6507,9470,36015,105784
3186,67682,187867,147698,55267,188791,147698,795003
5050,34125,51597,189798,20488,59890,189798,545696
3513,8855,9683,103,10121,9782,103,38647
9419,228797,130196,126903,120616,136539,126903,869954
5490,151428,518587,879167,145106,535473,879167,3108928
2768,44365,76945,26559,39848,77489,26559,291765
5220,19141,59611,155340,14749,65357,155340,469538
8498,30723,20651,4773,36135,20774,4773,117829
1434,10981,24120,22743,9329,26410,22743,116326
2860,28307,51519,16341,25769,53260,16341,191537
6283,4770,14,97,4396,15,97,9389
3845,19735,23458,15327,22374,23462,15327,119683
3908,7055,12884,3026,6639,12882,3026,45512
5564,198651,145658,8663,152586,147638,8663,661859
2861,36391,51247,27033,32297,55545,27033,229546
2956,1,0,0,0,0,0,1
8524,50771,70664,11223,53341,69548,11223,266770
6220,11306,971,1403,12567,989,1403,28639
5893,20853,19290,36265,21076,20167,36265,153916
1148,12364,28038,215,11999,28053,215,80884
7887,3477,351,518,3954,351,518,9169
9981,161499,150172,79685,152744,149724,79685,773509
9982,96,48,0,155,45,0,344
2656,3946,580,203,4265,580,203,9777
8647,1059,416,0,2460,412,0,4347
2149,6125,5909,2426,5987,5935,2426,28808
1391,99866,290813,204683,78103,320038,204683,1198186
1522,19080,48672,110155,22404,55401,110155,365867
4028,8852,20218,9575,8351,20227,9575,76798
4524,9761,13387,4420,9415,16060,4420,57463
3146,48415,104399,70895,41604,113598,70895,449806
8129,311,19,204,413,19,204,1170
3607,48648,171004,22262,47512,170322,22262,482010
5174,26926,84533,165958,24698,88411,165958,556484
5066,97214,163658,478196,79633,169599,478196,1466496
5590,42133,65235,102388,35482,72643,102388,420269
6818,31596,29541,35598,6334,28534,35598,167201
6085,97607,136015,196234,112646,141553,196234,880289
8067,9725,1520,1777,11896,1523,1777,28218
2138,9479,2103,236,10022,2121,236,24197
5417,190,2014,597,276,2438,597,6112
7766,14297,15930,1049,24511,10192,1049,67028
7506,57417,57308,19802,62581,57266,19802,274176
3194,3792,4285,4361,5473,4327,4361,26599
2691,2609,6026,0,2111,6123,0,16869
5235,44413,72796,184812,42924,76545,184812,606302
9909,73858,64001,32623,74328,64001,32623,341434
3054,146496,346513,216446,134134,346895,216446,1406930
5202,8033,13631,30626,5887,20860,30626,109663
6919,80876,90362,396623,57472,90426,396623,1112382
3314,10219,18753,2122,12077,18818,2122,64111
2356,18782,29646,16,16373,32297,16,97130
5236,21276,26773,134709,15037,32463,134709,364967
9983,41015,23580,13374,50017,23580,13374,164940
9676,24238,16392,15043,28367,16398,15043,115481
9630,45123,14720,16862,47417,14720,16862,155704
2231,24251,34745,258,31583,36193,258,127288
5539,36959,10624,23812,39547,10848,23812,145602
5591,21766,28352,53323,11268,37767,53323,205799
1870,25740,42422,20076,27440,43875,20076,179629
2398,10647,22345,7278,9788,26156,7278,83492
5880,10213,17506,28668,11082,19559,28668,115696
6086,148476,258408,330870,134085,270115,330870,1472824
5107,115516,218207,500513,59682,239951,500513,1634382
6880,34384,130048,256369,30073,137470,256369,844713
5141,1254,4734,8355,1310,7020,8355,31028
2901,4633,9496,2660,4921,10537,2660,34907
1221,21632,21780,11060,22635,21849,11060,110016
5308,692,1938,4407,734,4141,4407,16319
5941,3365,1180,2412,4249,1128,2412,14746
2437,20422,55842,4667,20166,55466,4667,161230
9738,6679,6341,2035,7804,6339,2035,31233
6979,15470,23823,30836,11521,24928,30836,137414
4794,1878,3140,1604,1783,3351,1604,13360
5717,11276,67888,24501,10820,70465,24501,209451
8436,10936,5452,289,9906,5225,289,32097
5418,50625,91284,166360,23836,102555,166360,601020
5523,38169,64485,80394,37165,76254,80394,376861
2193,58228,93189,1548,59457,103681,1548,317651
2432,11390,595,327,11571,597,327,24807
2828,6679,7207,513,7594,7212,513,29718
4189,185,158,149,182,168,149,991
5365,63339,140173,153102,57216,156125,153102,723057
8212,49241,28869,35840,42017,28868,35840,220675
6015,38340,27259,93424,21983,27680,93424,302110
8499,113597,80497,21306,115879,76268,21306,428853
5309,88669,267254,366751,89682,275057,366751,1454164
5562,25084,44713,79445,17506,54707,79445,300900
2105,5697,1483,240,5771,1479,240,14910
2399,593,672,77,546,679,77,2644
2303,28135,44287,5377,25477,43070,5377,151723
5563,36500,43035,43005,30378,46325,43005,242248
5273,69822,287500,267292,54617,289642,267292,1236165
1563,4961,10673,4685,1868,15236,4685,42108
8071,3675,1184,6949,3565,1181,6949,23503
2194,16548,36219,136,21923,46337,136,121299
6221,99,35,0,113,36,0,283
1862,37005,36522,12124,33754,36681,12124,168210
8437,302088,491622,42622,318179,484630,42622,1681763
8126,251672,439219,161658,237545,439913,161658,1691665
2937,1855,1747,685,1516,2602,685,9090
2558,2270,2307,563,2317,2308,563,10328
3072,19307,27191,26927,26466,29132,26927,155950
8098,4481,4159,604,5632,4157,604,19637
6108,61878,195275,252011,57550,203103,252011,1021828
8921,15530,3703,6179,16033,3701,6179,51325
2235,61565,76840,6052,62445,84887,6052,297841
5463,21919,53466,94433,16249,56820,94433,337320
8099,5803,6342,5807,5425,6340,5807,35524
2160,50750,117695,1130,49868,117671,1130,338244
2829,3738,6019,1356,4132,6404,1356,23005
2959,3004,2005,2421,2406,2546,2421,14803
6310,3938,593,686,4252,603,686,10758
9845,192832,110924,61413,193935,110924,61413,731441
6851,171,4006,5842,1504,4577,5842,21942
9618,12472,2161,6218,13420,2162,6218,42651
5495,21361,35859,43526,12972,40998,43526,198242
6881,196548,417416,692921,137818,433411,692921,2571035
8568,121124,179089,6055,122065,176097,6055,610485
2122,1048,61,5,1004,68,5,2191
2236,1978,1553,702,1838,1799,702,8572
6882,28619,50547,156993,23589,56618,156993,473359
8922,12951,4294,7597,13759,4287,7597,50485
8648,1304,617,0,1648,619,0,4188
8778,285,65,798,542,65,798,2553
9136,99972,117408,138743,97163,117364,138743,709393
9646,4166,3980,1540,5142,3982,1540,20350
8649,99710,178718,9831,89190,178679,9831,565959
8614,93,85,0,126,85,0,389
8924,26173,11521,13932,24721,11523,13932,101802
7217,212806,367996,249448,206845,375452,249448,1661995
2817,17343,22098,6128,18559,24657,6128,94913
9508,117778,134975,45174,127359,135002,45174,605462
5592,24972,29529,13273,28990,33553,13273,143590
3110,3110,5861,2884,4024,5885,2884,24648
3170,7235,8907,17904,12927,12628,17904,77505
3555,2666,4235,2584,3360,4254,2584,19683
2244,74324,119463,2968,12506,31707,2968,243936
1097,21365,16897,498,19390,17052,498,75700
4081,320,664,26,343,660,26,2039
9648,159697,133550,71505,170554,133564,71505,740375
9995,42868,26268,23131,50157,26273,23131,191828
2605,3959,5432,1753,3406,6064,1753,22367
5038,5039,6913,6921,5911,7438,6921,39143
8468,185713,149706,18424,186707,153727,18424,712701
8925,15049,9683,2437,16586,9704,2437,55896
6838,15441,47500,247264,13934,53481,247264,624884
3325,22949,41756,16875,26824,42022,16875,167301
1384,113,495,700,228,315,700,2551
5678,133,4561,0,119,4584,0,9397
5079,952,1027,1382,834,1332,1382,6909
5205,7077,8698,11874,8005,9975,11874,57503
1976,19860,22913,4506,20395,23118,4506,95298
5419,16072,30231,78912,7896,32625,78912,244648
7011,1915,226,2147,1938,226,2147,8599
9816,6396,3781,1453,8171,3781,1453,25035
1447,69594,132845,286160,22771,135877,286160,933407
1448,13692,29235,13198,12097,31857,13198,113277
3092,125637,103056,90766,41051,98251,90766,549527
5080,27062,44048,137525,17889,49207,137525,413256
1449,9638,17329,6161,10253,17628,6161,67170
1553,6339,11938,24249,29801,18992,24249,115568
1399,23425,64109,27543,21432,65488,27543,229540
1966,6315,3194,1297,5624,3207,1297,20934
1857,71067,133498,97306,76382,133609,97306,609168
5593,20607,22582,6793,30165,21695,6793,108635
5594,253422,224494,208802,117838,220441,208802,1233799
3571,2699,470,1075,2632,470,1075,8421
3237,19909,12676,18220,20394,12834,18220,102253
5108,41882,63131,170619,19678,68874,170619,534803
4581,72264,169305,102855,78246,171561,102855,697086
1229,10935,6859,3838,11661,6887,3838,44018
4132,1452,2181,672,1710,2180,672,8867
1415,19607,29966,29735,17113,32003,29735,158159
7516,316,413,0,327,413,0,1469
8652,88,20,0,61,20,0,189
4083,1300,2208,10,1595,2225,10,7348
9512,52743,68141,26637,61296,68159,26637,303613
9516,6531,6702,7961,6843,6695,7961,42693
9960,26409,10975,2761,34338,10973,2715,88171
9517,117125,119562,73740,115518,119577,73740,619262
8653,241,97,0,194,98,0,630
3008,10660,31031,12768,10187,32608,12768,110022
9142,8012,9064,9791,8117,9063,9791,53838
1427,146095,405761,254621,119835,260100,254621,1441033
1392,26177,58639,76548,19191,67077,76548,324180
7115,44923,127440,24444,39257,131377,24444,391885
1109,65682,72306,2286,69718,72352,2286,284630
5823,840,995,1579,887,995,1579,6875
9817,25533,14423,8816,23568,14422,8816,95578
4508,5381,6527,2727,9711,6604,2727,33677
9217,7231,2037,3757,6715,2037,3757,25534
5565,173872,629604,255394,206016,632589,255394,2152869
5366,11613,14998,32840,13573,16238,32840,122102
8655,4853,3810,62,4853,3925,62,17565
3073,8524,9067,7027,14025,9615,7027,55285
6862,210,1901,6248,1610,2154,6248,18371
6527,9547,12447,2286,9548,12260,2286,48374
1867,19328,36560,6232,15748,36470,6232,120570
1959,1898,3965,1301,1877,4229,1301,14571
2124,63017,121062,1028,75421,146775,1028,408331
2057,7634,2443,1084,7512,2449,1084,22206
9145,77891,171994,69472,86769,171852,69472,647450
9518,2083,2233,232,2220,2249,232,9249
2245,61538,86115,1966,47352,101953,1966,300890
2668,56690,18565,15268,59941,18820,15268,184552
9771,22763,15355,12362,26339,15355,12362,104536
9230,10439,2832,6381,10637,2837,6381,39507
9766,20430,19219,4403,21228,19212,4403,88895
6466,75,6,0,101,6,0,188
6401,5060,5370,1441,4745,5041,1441,23098
6565,3138,2941,1527,3427,3016,1527,15576
8214,42881,61869,27134,46478,61929,27134,267425
6088,36845,37506,72123,38576,41245,72123,298418
4206,4963,5091,86,5000,5188,86,20414
5109,4578,5687,31654,6306,8518,31654,88397
8546,13082,14752,207,12991,13863,207,55102
4228,964,806,0,975,767,0,3512
2848,43920,53334,12607,47253,53404,12607,223125
8657,9217,8689,0,13991,8695,0,40592
9149,5243,5454,1767,5955,5456,1767,25642
5057,39212,73855,142508,20009,80665,142508,498757
7445,103418,113517,479420,87527,123454,479420,1386756
8658,1035,673,0,1423,681,0,3812
5504,23755,2105,3203,24843,2069,3203,59178
7201,189,165,0,175,165,0,694
9956,5910,5888,1798,7976,5888,109257,136717
4084,415,481,0,348,486,0,1730
9710,48266,36930,19256,47340,36927,19256,207975
2685,184535,288917,54581,181236,287283,54581,1051133
5275,55743,144751,85000,52938,150573,85000,574005
1017,6369,8353,218,6189,8367,218,29714
9652,11757,8568,4017,16203,8567,4017,53129
2735,4997,3764,1143,3587,3849,1143,18483
3171,34805,71031,71217,35778,75117,71217,359165
4607,12824,9036,1915,12875,9169,1915,47734
1761,10726,7251,3660,11489,7385,3660,44171
9818,34083,22228,13810,41876,22223,13810,148030
2058,4619,1589,3698,4799,1590,3698,19993
1871,1,1,0,0,1,0,3
5824,1340,973,4541,1471,973,4541,13839
4595,5433,4500,728,7105,4877,728,23371
9876,45273,34483,51875,48765,34498,51875,266769
9521,81046,66233,16458,75558,66249,16458,322002
3225,14447,2844,4223,13555,2861,4223,42153
2669,10024,5251,3816,10244,5288,3816,38439
2059,3284,745,2964,3455,747,2964,14159
1133,13123,16997,176,17709,17041,176,65222
1534,44320,125369,200880,38327,135271,200880,745047
7925,887,1027,8451,1011,1027,8451,20854
4597,122152,223095,26098,118668,224608,26098,740719
2237,31902,50405,247,33001,58587,247,174389
5368,91968,181802,219283,102274,179493,219283,994103
4784,15125,23273,11632,15405,24240,11632,101307
5110,57065,106007,333231,26234,115802,333231,971570
8487,1983666,2500426,448706,1962493,2560056,448706,9904053
1947,433369,895756,259915,434824,896898,259915,3180677
5294,2255,5413,4830,3293,5651,4830,26272
7446,54695,131755,395546,47041,147758,395546,1172341
1373,49032,184408,317740,36835,201478,317740,1107233
3539,1007,1452,0,954,1388,0,4801
3498,911,7321,0,1105,7256,0,16593
5111,10415,18283,33379,10383,20218,33379,126057
9955,141095,104771,109257,165917,104774,794,626608
3620,10665,21431,2780,12587,21537,2780,71780
6089,77461,143739,179947,73770,152193,179947,807057
9188,19709,90758,3786,21561,90892,3786,230492
2862,23042,52210,10890,19318,52645,10890,168995
5329,89238,424898,300757,89571,428173,300757,1633394
5051,135945,440008,726437,102617,453209,726437,2584653
2710,72676,36520,25840,74044,37621,25840,272541
7402,9609,5748,2306,10664,5787,2306,36420
7403,9467,4745,5834,10509,4990,5834,41379
1177,80761,112874,43975,79456,113846,43975,474887
1291,26429,27603,18925,27917,27759,18925,147558
1579,1532,6430,5425,1403,7074,5425,27289
7491,7817,6444,15922,27651,7724,15922,81480
6340,185278,190208,48398,176961,189514,48398,838757
5369,13843,53961,100166,10510,58572,100166,337218
7305,8139,448,2689,8809,449,2689,23223
9438,131450,104555,147939,150541,104489,147939,786913
5634,30314,62744,70894,27188,68441,70894,330475
3573,43062,46214,7046,43965,46106,7046,193439
5635,19308,46658,40296,19055,49128,40296,214741
3853,13376,19683,9938,14863,19681,9938,87479
3066,245,144,593,669,168,593,2412
2156,18939,11236,2042,21405,11307,2042,66971
2661,16996,30428,11951,15971,33222,11951,120519
5260,22343,146539,58516,20315,146568,58516,452797
5498,13896,32952,35726,10184,36938,35726,165422
7072,4605,4743,8443,7434,5276,8443,38944
2242,550458,1225242,4379,28875,118232,4379,1931565
2246,1078442,2967725,134844,1697217,3775841,134844,9788913
9371,75532,47827,55201,83591,47836,55201,365188
9372,24912,16638,19652,27343,16658,19652,124855
4327,212,367,678,231,322,678,2488
4356,1348,1672,42,1537,1918,42,6559
4226,253,241,0,313,256,0,1063
4018,8294,14401,11640,9087,14397,11640,69459
3844,39902,57937,25536,41182,58078,25536,248171
4460,631,454,0,603,453,0,2141
4334,53,103,0,68,138,0,362
4248,2129,2814,0,2256,2856,0,10055
4059,3600,4596,268,3374,4618,268,16724
4227,7047,10596,5,6949,10505,5,35107
2484,46941,85380,11024,48059,85624,11024,288052
2485,35794,61470,11266,34324,60952,11266,215072
4247,672,836,0,612,850,0,2970
4133,31451,54119,18428,34190,54038,18428,210654
2488,3231,1919,949,3810,1941,949,12799
2467,1246,1176,718,990,1204,718,6052
4060,699,978,0,790,1061,0,3528
4162,486,607,0,479,621,0,2193
4302,2,2,0,0,2,0,6
4138,265,354,0,285,364,0,1268
4207,173,211,0,177,231,0,792
3847,15933,22948,10289,18322,22956,10289,100737
2457,12842,921,11085,12679,932,11085,49544
4223,6472,6678,943,7495,6677,943,29208
4061,289,491,5,338,533,5,1661
2455,717,30,0,661,30,0,1438
4163,1510,2196,268,1547,2173,268,7962
4421,3044,4526,5757,3133,4398,5757,26615
3852,7020,14967,10082,7170,14971,10082,64292
8712,589,263,0,708,268,0,1828
8846,386,409,0,389,411,0,1595
8829,757,187,0,868,186,0,1998
8830,152,55,0,267,55,0,529
9156,4406,4756,1472,4486,4754,1472,21346
8660,158,57,0,106,57,0,378
9655,10983,8247,2173,13512,8245,2173,45333
9614,3723,15030,1,4370,15054,1,38179
8443,6504,3013,449,6179,2829,449,19423
5112,69705,109771,347804,35306,36222,347804,946612
5148,2071022,8352830,26679531,3959109,8465248,26679531,76207271
5142,30797,202278,2216759,9884,40226,2216759,4716703
5143,214157,985527,1158793,117015,381115,1158793,4015400
1444,1659739,6638578,4839449,2308685,6496386,4839449,26782286
7490,551409,1215048,5704673,891622,1125942,5704673,15193367
6966,584,134,253,3017,148,253,4389
6121,1994158,6851268,10842260,2895747,6780862,10842260,40206555
6965,1534866,4290500,11971993,1509794,3907998,11971993,35187144
1475,382123,889794,912283,403471,889746,912283,4389700
3087,1682132,5149190,3801501,1733233,4981635,3801501,21149192
5281,22959,83791,31067,22491,84526,31067,275901
5632,25057,34678,91160,25198,31860,91160,299113
1555,485375,868442,247939,462417,855667,247939,3167779
5426,3281145,8555210,14193183,4215574,7874817,14193183,52313112
5598,2406381,10459232,16076575,4027600,9743045,16076575,58789408
1067,11108,27230,15106,10214,31263,15106,110027
1829,75284,70221,36251,72313,70799,36251,361119
2657,3168,607,83,3250,610,83,7801
7978,8099,6549,3356,8863,6553,3356,36776
1110,54102,49288,4586,47642,49263,4586,209467
5674,2164,373,1907,2557,295,1907,9203
5114,35899,90525,118127,22783,109790,118127,495251
9354,27015,12961,15415,32568,12971,15415,116345
1305,4007,2037,1173,3800,2104,1173,14294
1306,5588,2899,2834,6708,3010,2834,23873
3574,13471,18226,577,14223,18231,577,65305
2307,4810,2578,890,5861,2583,890,17612
2689,17300,3136,3567,19084,3138,3567,49792
2598,20905,28564,16261,16298,30244,16261,128533
3517,8644,7660,1942,8925,7673,1942,36786
1897,140761,169680,55522,148444,169177,55522,739106
5082,16558,22153,63098,11493,21011,63098,197411
6202,4868,948,1669,4324,974,1669,14452
6941,84528,117507,343766,54710,117076,343766,1061353
5053,22508,20987,68744,13931,26773,68744,221687
7268,51000,85097,2211,51451,85209,2211,277179
3635,14576,37969,11843,16135,37914,11843,130280
1536,138411,647447,374043,145867,674576,374043,2354387
3645,0,1,0,4,1,0,6
3518,90,68,0,112,68,0,338
4826,8550,17599,3587,9290,17697,3587,60310
4640,7453,5042,2144,7993,5297,2144,30073
5892,7177,31401,6798,8306,33194,6798,93674
5887,14768,40753,11714,12716,39310,11714,130975
5761,7946,14954,6669,8981,14982,6669,60201
5762,10844,17204,1973,6384,17392,1973,55770
5906,2090,4585,5203,2235,5633,5203,24949
2670,19133,13987,2250,20178,14189,2250,71987
2871,107724,217150,42836,103765,216426,42836,730737
4422,11638,19755,134,12314,19790,134,63765
3963,11452,31817,3804,11308,31820,3804,94005
3962,947,976,171,708,978,171,3951
2155,86115,101944,9713,100200,122847,9713,430532
5853,3300,5490,1841,3244,5488,1841,21204
3147,259212,500278,456048,235514,535646,456048,2442746
5237,23,69,10,41,79,10,232
5115,41458,165576,178394,24987,126700,178394,715509
5222,117200,281771,135445,128260,313742,135445,1111863
5599,15803,25697,49797,11536,27357,49797,179987
8831,21989,9202,0,24867,9461,0,65519
8164,32483,38260,32354,35427,38368,32354,209246
4884,47281,23476,11285,46717,23938,11285,163982
2961,156787,418866,20039,129676,387333,20039,1132740
2966,59657,175466,24092,21439,131670,24092,436416
2968,1417375,4371082,962084,1578430,4406799,962084,13697854
2970,50503,193795,23243,13516,100405,23243,404705
7165,199,55,19,231,56,19,579
6856,14853,68872,124585,11714,72317,124585,416926
6883,35295,56306,143438,38701,56848,143438,474026
2253,14382,23571,173,13732,23498,173,75529
4094,757,902,21,783,903,21,3387
7603,249,4,23,363,4,23,666
1727,28340,69060,9967,33649,69412,9967,220395
1728,14389,27731,9979,11576,27539,9979,101193
7166,23438,43719,16705,26101,43933,16705,170601
5223,9982,25733,79042,8395,29763,79042,231957
5018,25518,168379,44406,24341,169793,44406,476843
1909,45523,61835,39185,49122,61988,39185,296838
6318,5952,13904,1625,6720,14156,1625,43982
9160,12334,14446,9073,14519,14455,9073,73900
6863,8389,27914,93992,6978,28744,93992,260009
3021,29715,60140,40383,31528,60725,40383,262874
2830,33583,58617,18767,31201,60381,18767,221316
8445,11068,14338,1900,14969,14705,1900,58880
7928,7534,8455,3916,11023,8476,3916,43320
1034,27804,40020,282,28594,39821,282,136803
5040,2749,7931,6750,2477,8951,6750,35608
5692,44060,66505,82785,40788,69264,82785,386187
7947,669,649,278,826,649,278,3349
9957,9809,7096,3238,12600,7097,1798,41638
6970,16439,17037,65690,17075,17052,65690,198983
1988,20646,11440,7351,21798,11462,7351,80048
1581,20569,34832,6231,21044,34962,6231,123869
1582,5848,7155,88,5048,7151,88,25378
2867,14238,23933,4870,12998,26145,4870,87054
9802,26854,16716,8676,30369,16716,8676,108007
9529,10705,3491,3583,9206,3521,3583,34089
5149,66769,119544,187658,31556,129306,187658,722491
7036,10097,9669,13109,15043,10458,13109,71485
3346,829,95,993,855,103,993,3868
1851,16565,55974,25822,21949,52675,25822,198807
7221,3511,2352,973,3959,2406,973,14174
3576,1596,226,2512,1612,227,2512,8685
8574,48357,53185,809,52133,49362,809,204655
2254,26127,37312,812,26596,44207,812,135866
2357,7636,3779,1868,7387,3764,1868,26302
5116,16479,42766,71160,10422,50204,71160,262191
5475,29823,52995,119241,23715,60537,119241,405552
3855,19843,49583,12099,20690,49652,12099,163966
3857,2785,9609,16758,3250,9611,16758,58771
5677,43,120,158,74,265,158,818
6297,26543,1731,13911,30266,1757,13911,88119
7725,98283,169630,1839,113225,184744,1839,569560
6707,20145,53059,9436,19344,51616,9436,163036
5908,3917,4095,10337,4373,4581,10337,37640
8477,27008,21777,3778,25373,21631,3778,103345
7929,171185,220761,67605,166221,220924,67605,914301
2971,1794,3176,953,1884,3743,953,12503
3159,3161,3505,4963,5586,3943,4963,26121
4095,5107,13580,599,5218,13635,599,38738
5644,14400,14215,46596,12279,18599,46596,152685
1527,46825,140211,283460,36751,149799,283460,940506
2750,14640,10904,3687,12020,10920,3687,55858
1537,510,2342,2048,579,2674,2048,10201
5909,650,522,2290,765,614,2290,7131
9658,22508,19853,7547,27104,19854,7547,104413
1997,17635,41699,43651,19514,41671,43651,207821
2920,21295,30111,12641,17444,35953,12641,130085
9985,169858,88472,47576,177594,88488,47576,619564
2922,9834,23303,6606,8339,24772,6606,79460
1378,206230,674417,675973,204808,680115,675973,3117516
4469,834,850,2541,893,856,2541,8515
5019,7391,12800,12402,6845,14634,12402,66474
8518,26025,22844,1340,28074,21709,1340,101332
6906,496,2425,7872,1333,2549,7872,22547
5374,242,346,195,761,751,195,2490
5427,8468,12587,22978,7509,14001,22978,88521
2849,2143,2177,348,3132,2155,348,10303
9060,27,238,636,52,239,636,1828
3067,886,2600,3828,4172,2613,3828,17927
3203,20741,2775,4577,20026,2776,4577,55472
9080,40624,61292,16360,42872,61366,16360,238874
2226,131843,159790,10624,23112,53383,10624,389376
6005,0,0,245,0,0,245,490
2799,5328,8044,3554,4610,8542,3554,33632
8539,14574,28155,4761,17511,27603,4761,97365
8833,2063,315,0,2141,317,0,4836
5825,445,373,1350,827,375,1350,4720
5303,45,125,2466,214,227,2466,5543
5291,1096,1153,9568,1866,2292,9568,25543
2695,54026,38284,5383,53815,38682,5383,195573
5957,3955,10883,4545,4024,13602,4545,41554
4814,14133,51116,7075,13883,52966,7075,146248
2151,27384,49777,652,29475,63357,652,171297
4470,935,1263,194,1235,1420,194,5241
8504,17204,7301,1740,16585,6468,1740,51038
7680,24387,16442,14808,21689,16487,14808,108621
5501,17694,32779,35990,17608,37483,35990,177544
5600,73249,117718,227484,60334,119662,227484,825931
2606,1864,2271,1067,1922,2566,1067,10757
2675,1853,61,158,2050,62,158,4342
2171,14040,20705,1308,13400,20692,1308,71453
2903,15558,30880,10587,14011,32944,10587,114567
9632,14812,13402,3268,15345,13403,3268,63498
2973,8031,12778,3658,7022,15196,3658,50343
9691,147178,159182,49599,146162,158964,49599,710684
5645,41835,65524,132742,32647,72627,132742,478117
5118,65017,84095,253757,35941,98291,253757,790858
2158,1977,2300,91,1963,2325,91,8747
5312,10166,35286,20458,11272,36855,20458,134495
9819,111085,68665,53732,112127,68664,53732,468005
3859,9257,28899,7972,10688,28897,7972,93685
9779,8021,5725,2420,10973,5726,2420,35285
8665,4942,714,0,6038,714,0,12408
9608,55025,34629,81781,58089,34630,81781,345935
9304,45402,9641,27874,45703,9645,27874,166139
8526,17626,16302,419,19558,15608,419,69932
8107,4524,4436,4902,4145,4438,4902,27347
3389,34175,20784,28579,35442,21023,28579,168582
8666,20896,8146,5429,22747,8143,5429,70790
1247,7741,7224,3172,8403,7264,3172,36976
4098,1357,1886,213,1466,1898,213,7033
1881,23182,21667,31518,21808,21768,31518,151461
2940,6584,6665,3693,6920,7625,3693,35180
4216,67730,136108,25411,70495,136347,25411,461502
7354,2183,658,465,1828,660,465,6259
9773,40623,40384,116401,41500,40377,116401,395686
2565,11241,15835,6571,11471,15876,6571,67565
2139,12115,1954,832,11848,1970,832,29551
6241,3002,371,1293,2955,555,1293,9469
2047,490,44,266,622,44,266,1732
5911,8454,11939,9293,7628,12915,9293,59522
6018,52866,57597,174116,38799,57827,174116,555321
5058,46441,40470,156641,25423,55614,156641,481230
2152,32895,77630,532,28274,91974,532,231837
6289,147,2,0,185,3,0,337
5150,113609,240172,319665,82937,231599,319665,1307647
5345,77564,179494,260847,44551,180498,260847,1003801
9533,2213,752,239,2213,755,239,6411
5119,94847,134764,560623,50382,160268,560623,1561507
2923,5590,9802,2465,3867,10665,2465,34854
6209,10493,33,806,10511,36,806,22685
5238,10780,9516,6907,11306,9855,6907,55271
2358,756,742,26,991,743,26,3284
5567,118991,267288,345622,106878,281412,345622,1465813
2974,7984,15422,1609,8953,15448,1609,51025
2769,15894,27217,14425,16391,27558,14425,115910
5881,49367,127377,74379,48316,130810,74379,504628
8506,84014,66500,13408,88809,64822,13408,330961
6019,20015,7056,48213,16650,7427,48213,147574
6498,53,114,0,60,124,0,351
6499,121198,130704,45833,124106,131280,45833,598954
3074,121997,175780,187829,114747,179144,187829,967326
3071,3954,8436,3038,4108,8608,3038,31182
7728,740705,1478789,180309,704877,1451014,180309,4736003
5330,10358,22389,17523,16016,23190,17523,106999
5331,11020,27133,26792,8016,26862,26792,126615
5175,9487,20251,30587,9758,20843,30587,121513
7038,14741,6340,6739,17351,6584,6739,58494
7039,13255,17678,69306,11606,20382,69306,201533
3674,179870,382097,77971,186265,381202,77971,1285376
3523,6690,22597,5,6421,22447,5,58165
1863,8513,10140,4419,6812,10237,4419,44540
3426,54355,148679,62356,53362,147985,62356,529093
7834,5928,4421,579,6449,4421,579,22377
2789,14889,19370,10244,16065,20888,10244,91700
9774,28419,18926,18588,28325,18925,18588,131771
2257,25803,29649,21345,25566,30462,21345,154170
9571,8827,4988,4631,8882,4988,4631,36947
5828,222,70,0,263,70,0,625
8668,738,946,0,897,947,0,3528
4426,14604,17269,519,15543,17117,519,65571
3895,2679,4251,1673,3197,4251,1673,17724
9609,4320,3903,196,6736,3904,196,19255
5568,88877,179363,220136,67453,188267,220136,964232
5428,69239,160429,247315,37613,171744,247315,933655
5460,364,1277,665,481,1462,665,4914
8528,20380,23348,607,20667,22208,607,87817
9358,62177,39935,29869,61000,39952,29869,262802
5636,38283,52523,39410,37799,55349,39410,262774
5429,22118,33051,80025,10647,36404,80025,262270
9189,13686,23012,10731,14542,23013,10731,95715
7895,4033,2970,1728,3449,2970,1728,16878
5601,10344,7223,22037,15996,10147,22037,87784
7308,16849,19085,3049,17351,19150,3049,78533
1422,30845,64016,79567,24231,65560,79567,343786
6929,5114,5442,3108,5354,5697,3108,27823
7996,38561,75413,28407,41771,75425,28407,287984
1069,89394,426258,216227,85000,434947,216227,1468053
1111,52516,65466,1501,47355,66006,1501,234345
5120,4082,5547,8191,3600,9415,8191,39026
1478,7632,6249,6470,5919,6281,6470,39021
6971,3663,5505,5443,9399,5827,5443,35280
2326,27453,26983,4362,26090,27045,4362,116295
1356,2089,95,173,2428,100,173,5058
7309,229014,678121,67137,216792,669329,67137,1927530
5376,111263,206351,445877,73676,219072,445877,1502116
1826,545416,1209958,208803,547796,1213037,208803,3933813
1077,69549,134030,30764,72012,135067,30764,472186
5068,21403,32516,84529,11914,39894,84529,274785
7946,3486,1493,472,2678,1492,472,10093
5262,3076,4182,6192,5113,4416,6192,29171
5476,5697,12082,11277,6883,12869,11277,60085
4689,3723,4748,2169,3479,4938,2169,21226
1904,11979,56136,11379,11681,57231,11379,159785
6020,33990,36202,161902,23893,36731,161902,454620
8725,13387,32472,0,11678,32359,0,89896
7451,26445,22378,93700,23119,22582,93700,281924
5310,646,1273,5544,697,4132,5544,17836
4641,14703,12268,4816,12929,12341,4816,61873
2258,37648,47651,1407,38210,60641,1407,186964
2964,10887,30885,5,2079,30683,5,74544
3219,17885,8160,29208,18816,8165,29208,111442
2907,28464,66697,17363,29039,68924,17363,227850
2908,4350,12143,1544,4782,11849,1544,36212
4533,27636,32079,2682,25840,32099,2682,123018
5021,1474,3222,3780,1930,3662,3780,17848
2281,111351,170975,57302,123706,170222,57302,690858
5122,189619,440551,878239,124463,477551,878239,2988662
2259,5768,9394,1669,6357,9766,1669,34623
2247,62745,92893,2976,72398,118783,2976,352771
5071,23081,56218,99761,16451,63140,99761,358412
7273,14663,10657,243,15963,10667,243,52436
7274,4529,909,271,5126,898,271,12004
8309,31476,17096,1769,33597,16161,1769,101868
2157,16271,8928,937,18955,8943,937,54971
5526,4292,5847,21383,3913,7292,21383,64110
2090,31697,86360,4194,30767,86152,4194,243364
3115,299628,912352,319488,289960,923436,319488,3064352
5602,32856,55035,90443,22040,67352,90443,358169
5377,56454,159528,272689,42800,164870,272689,969030
5224,57664,131717,265613,48457,140842,265613,909906
2387,12932,7767,2008,12603,7792,2008,45110
3427,25866,109005,19472,24687,108785,19472,307287
9657,41387,26981,9205,38489,26981,9205,152248
9683,549642,439219,179810,546422,439128,179810,2334031
9664,4484,2870,1430,5303,2870,1430,18387
6021,58311,59216,211880,28347,59661,211880,629295
3036,29511,45972,66415,36162,49413,66415,293888
8479,24182,16899,14162,26703,16904,14162,113012
4250,608,644,0,552,637,0,2441
3524,15525,15184,874,16303,15229,874,63989
2402,14815,22069,3163,13826,22400,3163,79436
2967,0,4,0,1,4,0,9
1561,2564,7048,3107,2219,8954,3107,26999
5882,16777,18317,15612,17637,18394,15612,102349
3246,334,152,413,421,155,413,1888
9917,312595,152003,45123,291016,152004,45123,997864
2032,2092,326,621,1716,329,621,5705
3213,2015,368,854,2039,377,854,6507
2916,3277,5107,2090,2754,5775,2090,21093
9775,20480,13205,110386,20986,13205,110386,288648
1687,1037,24,602,993,23,602,3281
5423,61202,140420,346283,37497,145778,346283,1077463
7685,694,43,253,242,43,253,1528
2403,4954,7728,2625,3979,8057,2625,29968
4101,2819,5352,10,2994,5375,10,16560
4102,4237,7428,165,4344,7371,165,23710
4140,8768,12354,2759,9166,12347,2759,48153
4254,230,140,26,230,138,26,790
4129,710,720,210,621,727,210,3198
3863,44959,84392,36372,49064,84387,36372,335546
3851,20710,41035,9019,22554,41043,9019,143380
4021,12223,30423,12739,12013,30422,12739,110559
5072,50213,104702,182652,18134,94828,182652,633181
5378,16894,24817,30871,18646,50366,30871,172465
4335,1269,1476,145,1296,1520,145,5851
6634,14222,28232,2885,14875,27666,2885,90765
1195,14019,4372,2718,14967,4419,2718,43213
2494,1387,2768,795,1573,2821,795,10139
3499,15330,11533,211,14960,11525,211,53770
3992,2769,8439,1359,3131,8442,1359,25499
4473,1863,3369,19001,1854,3397,19001,48485
2102,28354,68822,4091,29230,68476,4091,203064
3525,11356,7733,220,11208,7727,220,38464
4463,247,528,0,280,542,0,1597
5477,1735,6216,6284,1740,7595,6284,29854
3944,1782,3304,519,1972,3307,519,11403
4409,1934,2598,77,2731,2531,77,9948
2433,6240,1005,180,7124,1004,180,15733
3526,47030,139462,1780,43481,138810,1780,372343
3528,3060,1551,248,3602,1552,248,10261
1128,28625,45024,1187,32055,44768,1187,152846
4887,5548,10562,4301,5368,12047,4301,42127
8805,54637,132092,41821,56993,132006,41821,459370
6133,211373,682166,382707,208493,679842,382707,2547288
5657,65621,159336,201221,60485,166554,201221,854438
5123,106090,152439,478938,72034,170916,478938,1459355
5461,9610,23725,11205,10724,24374,11205,90843
5462,184,303,367,180,380,367,1781
3062,8219,16152,19983,9251,16074,19983,89662
3214,5,17,0,8,18,0,48
5757,1339,563,1074,1254,539,1074,5843
8801,8088,16672,297,8190,16669,297,50213
7452,82659,95251,269127,67306,99449,269127,882919
2752,2316,1712,493,2847,1735,493,9596
8670,2616,1116,0,2554,1120,0,7406
5225,3581,8827,32397,2896,11280,32397,91378
2308,2747,4777,303,3268,4807,303,16205
5332,1697,5065,20007,1485,7186,20007,55447
5208,43853,65657,164521,18424,73446,164521,530422
3580,182697,430692,35640,180415,429614,35640,1294698
5885,26350,48652,38373,26399,49525,38373,227672
5455,25358,147673,83537,20138,155265,83537,515508
1078,944,532,162,956,549,162,3305
9820,37710,20179,12440,44746,20179,12440,147694
9804,13834,13192,3640,16881,13193,3640,64380
9821,27484,23050,13566,34604,23050,13566,135320
9623,31617,17616,17693,35143,17616,17693,137378
9936,51031,50037,70159,54912,50036,74849,351024
3422,5441,9904,1313,5005,9907,1313,32883
6819,12012,8161,17838,9578,8229,17838,73656
2459,1453,143,0,2082,160,0,3838
4251,453,395,0,424,405,0,1677
8540,19,63,0,32,77,0,191
8548,17529,12744,511,19553,12961,511,63809
8541,7560,4684,0,6667,4591,0,23502
4023,3627,11382,2999,2823,11386,2999,35216
3850,14254,18175,5102,14503,18190,5102,75326
3744,6502,6830,4272,7266,6860,4272,36002
3904,72455,174891,44676,69064,174967,44676,580729
5883,97841,294891,88023,96033,291673,88023,956484
8254,8748,6222,13719,8659,6221,13719,57288
9667,66595,66971,18295,67248,66974,18295,304378
2198,35097,50617,4128,35797,49512,4128,179279
4181,41082,78248,12578,42558,78094,12578,265138
5928,26399,38684,23585,27045,42339,23585,181637
3870,23033,57780,17427,24545,57788,17427,198000
4313,7978,13706,14101,8656,13114,14101,71656
8860,2368,409,1045,2436,409,1045,7712
5276,37553,87189,89053,36892,87040,89053,426780
5537,212883,700698,210253,230105,730649,210253,2294841
5829,149,74,199,138,79,199,838
5540,68591,136246,30314,54346,108149,30314,427960
9958,6011,3779,1340,6963,3779,3238,25110
6022,174001,173175,304253,156419,173245,304253,1285346
2671,40174,67430,16941,39241,67345,16941,248072
2874,29512,39324,11841,29949,39469,11841,161936
1346,1022,850,385,1011,866,385,4519
2337,16793,23796,563,15480,23317,563,80512
2521,28963,91372,13136,32109,91429,13136,270145
2875,8154,7715,4418,9555,7740,4418,42000
2753,469542,753099,156781,451938,752741,156781,2740882
5285,25316,65070,90688,20804,66252,90688,358818
9366,15884,7842,10421,18943,7842,10421,71353
2884,5,3,0,6,3,0,17
9544,7623,17613,1664,16651,17663,1664,62878
9543,59280,43749,23203,58462,43771,23203,251668
9808,4575,3751,1238,6323,3752,1238,20877
3055,40525,76166,73469,38923,76321,73469,378873
7419,7447,24723,62978,8766,26837,62978,193729
7509,26436,12298,7785,22622,12299,7785,89225
5468,14593,53363,82804,11863,59980,82804,305407
7453,28110,20701,70559,29408,20878,70559,240215
5379,93625,249825,387021,55726,270659,387021,1443877
5430,22846,33491,100831,10472,37698,100831,306169
5603,213993,354974,749940,163985,366766,749940,2599598
4314,4514,10278,19554,3682,10388,19554,67970
4185,5915,10532,3890,6646,10534,3890,41407
3994,3017,9151,1837,3667,9157,1837,28666
5176,17746,32084,16372,21069,34334,16372,137977
9822,66158,58622,29032,74079,58624,29032,315547
1419,35705,228710,576190,42507,227621,576190,1686923
5424,20832,31723,64081,7605,33912,64081,222234
5596,18074,15975,4788,15075,16202,4788,74902
3531,286,208,0,259,207,0,960
2631,0,1,0,0,1,0,2
6242,4160,658,345,4253,659,345,10420
1546,36373,99690,191888,29972,109561,191888,659372
3118,3050,5236,9954,5144,6651,9954,39989
3874,30791,40460,21701,29295,40425,21701,184373
2404,6301,4245,576,6426,4213,576,22337
5177,78738,209265,508524,69935,225241,508524,1600227
7454,42002,32584,227035,39224,31982,227035,599862
2296,29085,46024,3898,24377,43816,3898,151098
5023,40273,153974,98133,39316,150641,98133,580470
2734,8638,9720,2320,6789,9803,2320,39590
8834,4802,1502,0,4134,1509,0,11947
6361,662,5,31,783,5,31,1517
1999,4071,2174,439,4279,2191,439,13593
5083,8650,5618,30880,4048,8505,30880,88581
8519,2667,1339,0,3196,1262,0,8464
8031,275,12,0,274,4,0,565
6884,64200,191458,621241,53759,204211,621241,1756110
5569,178609,323408,424422,105402,337711,424422,1793974
3149,1137171,2104263,1511682,1094196,2095855,1511682,9454849
3160,1622,1955,15440,3244,1435,15440,39136
6967,11069,13221,59463,6812,16247,59463,166275
5912,2288,1066,3437,2731,1063,3437,14022
7932,110,12,237,111,12,237,719
7950,41525,65770,13880,46984,65835,13880,247874
7974,19200,18374,9187,19597,18383,9187,93928
2979,7609,17999,5577,7773,17819,5577,62354
2857,2,10,0,9,10,0,31
1208,73854,145827,10855,67298,146128,10855,454817
5478,186639,536960,468121,175908,546050,468121,2381799
3247,11264,2842,3105,12222,2840,3105,35378
3530,30920,52386,31,30945,52335,31,166648
5431,10126,10069,37576,4842,11269,37576,111458
7316,10042,3655,763,11002,3645,763,29870
5480,45305,70234,130246,44077,73520,130246,493628
9867,19583,15915,2358,18723,15916,2358,74853
6511,38438,44121,16212,39097,44200,16212,198280
3906,8886,19129,4832,10135,19132,4832,66946
2544,1379,1697,3430,1917,1699,3430,13552
2461,53949,207048,19269,53505,206675,19269,559715
4027,5953,20558,5845,5095,20570,5845,63866
2106,4233,695,0,4080,698,0,9706
2131,13362,20959,95,13740,21587,95,69838
5570,555670,1041575,743515,352026,1043356,743515,4479657
5432,10769,18730,65534,8055,21706,65534,190328
1538,724,2429,1634,472,2595,1634,9488
7510,5557,3149,2667,6108,3153,2667,23301
2580,11306,9258,2068,10476,9316,2068,44492
5226,9791,27864,63512,7920,31188,63512,203787
2261,14752,27801,257,14211,28830,257,86108
2924,62360,146712,25747,61441,152676,25747,474683
3532,82,125,0,118,125,0,450
5203,30479,141420,49776,27962,146111,49776,445524
6885,22915,76059,154380,23338,79733,154380,510805
2189,57247,113023,3110,51596,102688,3110,330774
8671,778,231,0,711,232,0,1952
6353,2814,610,460,2836,613,460,7793
2444,361,45,444,416,45,444,1755
6886,296071,518069,983635,268300,503055,983635,3552765
2833,24738,44459,15434,21798,46085,15434,167948
5943,24551,41041,20545,28391,41933,20545,177006
1962,3701,2470,1203,2923,2469,1203,13969
2722,7845,4231,1335,8292,4238,1335,27276
2873,10123,13407,7296,8641,13424,7296,60187
9190,10032,6291,20184,13542,6309,20184,76542
6676,59543,97995,17277,67527,97282,17277,356901
7297,846,445,0,884,445,0,2620
5658,7029,8132,10561,9044,8753,10561,54080
4606,31335,26900,2792,32581,27287,2792,123687
8835,1048,378,0,1011,378,0,2815
6829,9533,9359,22309,8746,10415,22309,82671
6090,63222,119771,171932,59720,125602,171932,712179
4477,4710,10372,545,5423,10482,545,32077
2315,3146,3955,637,3605,3940,637,15920
1087,107508,196377,83931,110761,195090,83931,777598
1084,342,329,139,476,436,139,1861
1135,10337,27041,153,7953,27050,153,72687
2291,50804,128274,7984,51058,127742,7984,373846
2294,44824,39951,6640,41158,40040,6640,179253
6327,21022,1035,3219,23031,1048,3219,52574
8174,635,527,0,838,527,0,2527
9787,94810,61542,24590,96470,61542,24590,363544
5542,106883,57582,19668,116237,56588,19668,376626
5541,50442,6561,21492,36034,6110,21492,142131
5543,30475,2852,13974,30269,2828,13974,94372
2977,4228,5547,797,3518,6030,797,20917
5024,11692,75154,20031,11480,76630,20031,215018
6820,31564,21862,46041,29275,23265,46041,198048
2809,0,4,0,0,4,0,8
2794,69929,159047,36164,75707,141907,36164,518918
2798,9920,14902,6478,14310,6935,6478,59023
5380,5611,4905,18748,9048,6381,18748,63441
7318,632,379,10,666,431,10,2128
5663,111252,325312,113309,109161,330541,113309,1102884
8561,67562,55806,4782,66576,52865,4782,252373
3587,9725,3997,1085,9657,4010,1085,29559
7951,38400,39031,12332,30615,39061,12332,171771
9547,59418,59890,12506,68211,59885,12506,272416
8033,1167,1159,945,802,1159,945,6177
2673,200,15,170,220,14,170,789
8358,23038,18563,784,23178,17714,784,84061
1261,21774,16579,10312,23599,16656,10312,99232
5433,31257,70505,158837,15795,73087,158837,508318
2249,56823,37413,1288,48629,58466,1288,203907
5646,12192,18829,22508,14950,21413,22508,112400
5025,8435,17657,36176,7968,19574,36176,125986
5525,65753,9327,19300,69202,9206,19300,192088
3584,422,279,0,542,279,0,1522
1149,39497,66709,2896,41801,66312,2896,220111
5026,12925,33666,69828,14287,33791,69828,234325
6172,17165,37328,57809,16655,41862,57809,228628
2388,11552,10394,3732,11235,10595,3732,51240
9549,1659,3843,201,1704,3846,201,11454
4270,3171,8569,803,3837,8565,803,25748
4108,430,992,33,604,992,33,3084
3056,2415,2893,4921,6944,2913,4921,25007
6806,29141,31764,106255,27865,36729,106255,338009
6328,11267,713,1640,12837,714,1640,28811
7224,11676,17003,888,12313,17017,888,59785
8185,117457,205205,31329,113153,205344,31329,703817
8672,183,66,0,184,66,0,499
9996,59993,32211,14794,57721,32210,14794,211723
6456,33112,57870,9929,33770,57931,9929,202541
3254,8745,1595,1188,9132,1592,1188,23440
7641,26910,31463,1073,33977,20303,1073,114799
5333,21273,87252,77672,17475,90305,77672,371649
2250,35267,68475,79,29297,63786,79,196983
7814,16713,15472,5322,15696,15424,5322,73949
8178,6679,5977,4422,7485,5981,4422,34966
2003,6352,2158,5068,6762,2258,5068,27666
8007,2990,2718,736,3066,2745,736,12991
3061,9147,19891,17896,10042,19951,17896,94823
8201,34494,43084,72555,35773,43473,72555,301934
5434,25295,106336,99669,25692,113072,99669,469733
2004,16594,1378,90195,13494,1272,90195,213128
5179,2570,5380,13532,3463,6729,13532,45206
1105,76716,157942,3582,86666,157703,3582,486191
2107,51722,8064,586,45937,8035,586,114930
6893,63807,97708,284897,46754,97677,284897,875740
5124,149432,463282,852846,116134,500240,852846,2934780
3205,16359,2387,2069,15372,2381,2069,40637
3679,9511,6749,14966,10995,6755,14966,63942
5638,5451,4693,18425,5690,4989,18425,57673
5529,102977,21447,17413,102083,20711,17413,282044
2925,32146,63557,19402,30924,66168,19402,231599
5929,6167,4449,10190,5731,4876,10190,41603
9823,17181,10340,54931,20502,10340,54931,168225
5184,38600,119257,53353,34768,125283,53353,424614
6663,100973,382675,15561,96609,383565,15561,994944
6691,538031,1087681,140222,533645,1094284,140222,3534085
7043,10314,11853,18653,11215,12443,18653,83131
6888,146635,276773,688305,111493,297161,688305,2208672
1178,19337,5622,18750,24310,5648,18750,92417
5186,7350,13607,10041,6969,15947,10041,63955
8448,7377,6644,260,6855,6304,260,27700
5605,23958,67079,48154,17443,71097,48154,275885
7044,2721,4924,8470,4274,5518,8470,34377
5835,9851,47740,4146,8787,48605,4146,123275
8257,3314,232,1714,3567,232,1714,10773
7319,13781,22256,427,13487,22279,427,72657
9903,94930,53898,124520,91449,53901,124520,543218
9552,2330,1856,394,2972,1856,394,9802
4619,14734,10393,6406,14406,10701,6406,63046
7893,11124,5153,782,12205,5152,782,35198
3150,9334,14544,11692,9601,18086,11692,74949
8347,123914,106972,9056,124875,104089,9056,477962
7073,188,63,0,159,68,0,478
3009,372,707,395,575,720,395,3164
3206,12103,2033,1811,11523,2042,1811,31323
6570,2343,830,868,2387,830,868,8126
4526,31679,35172,2502,31321,35438,2502,138614
7455,20139,54749,62733,18834,58003,62733,277191
5930,4215,4129,3740,4762,4753,3740,25339
5277,57321,239327,160593,47733,248229,160593,913796
5074,675,3047,3359,692,6223,3359,17355
5084,44864,75186,289905,31836,84601,289905,816297
2546,48435,26097,4408,49333,26548,4408,159229
9739,18994,23058,3618,20313,23069,3618,92670
4387,124869,382083,63843,120591,382051,63843,1137280
5125,132245,190643,626722,83779,219525,626722,1879636
1902,26872,791,6092,23826,795,6092,64468
2000,844,381,1534,764,378,1534,5435
6782,3735,6566,243,3964,6748,243,21499
6972,26673,27038,42195,21267,28650,42195,188018
1968,7210,8119,3416,7841,8144,3416,38146
6932,5629,8865,5879,6714,9182,5879,42148
1845,149,3,605,180,3,605,1545
1849,5,1,0,3,1,0,10
9988,162737,119665,30211,136335,119665,30211,598824
5187,106755,280357,360124,100344,281117,360124,1488821
6265,40725,97332,18927,37852,97773,18927,311536
4217,5951,7288,1087,7247,7288,1087,29948
2728,143034,59729,49081,140896,59700,49081,501521
5154,16975,20115,85119,15512,25184,85119,248024
8450,25338,18699,2211,22057,17082,2211,87598
9236,3672,732,2259,3927,742,2259,13591
6362,47432,28293,36295,47087,28241,36295,223643
8179,976,742,0,805,742,0,3265
3172,341387,747283,421367,331958,764198,421367,3027560
4530,8156,11842,10,8893,11755,10,40666
5494,986,173,0,1038,172,0,2369
1114,19109,18457,195,19475,18921,195,76352
1150,15307,22260,405,17950,22254,405,78581
4534,2,0,0,2,0,0,4
5382,6033,10288,27295,3559,12487,27295,86957
2660,11960,19979,3906,11098,22036,3906,72885
8036,615,10,0,1022,10,0,1657
5189,23059,48323,27918,23400,57171,27918,207789
5185,1243,4143,4547,1171,4981,4547,20632
5126,4410,9342,15688,3164,11232,15688,59524
4527,70014,110295,12302,69085,110733,12302,384731
7320,2151,958,245,2403,962,245,6964
1452,5931,9292,4786,5928,9694,4786,40417
7953,823,50,21,574,50,21,1539
5425,17451,12468,35926,12506,21948,35926,136225
5410,39605,53735,180499,28889,51588,180499,534815
8355,28262,55360,12982,27984,53804,12982,191374
3138,1344,1253,1782,298,2578,1782,9037
9318,77386,19680,51801,84854,19736,51801,305258
1451,7647,5985,12455,7121,6367,12455,52030
1453,16520,29525,30179,10206,31226,30179,147835
5292,4081,2915,2791,1882,4346,2791,18806
8142,11521,5261,8578,11030,5273,8578,50241
7404,8483,6343,831,9617,6525,831,32630
1949,8122,12118,4540,8405,12194,4540,49919
3187,35000,107967,93485,29483,112461,93485,471881
5932,335645,936789,338855,327177,939248,338855,3216569
5922,83748,168031,133817,77765,165007,133817,762185
5263,16414,32618,26710,16496,35520,26710,154468
6947,31302,39591,36445,28100,39199,36445,211082
5339,409,1189,799,492,1288,799,4976
7456,154271,560741,201188,163900,576209,201188,1857497
7457,22975,43494,157276,21450,45446,157276,447917
7420,62745,151054,200581,23090,147406,200581,785457
6890,5298,17410,30453,3748,19965,30453,107327
2262,144778,463455,12002,160207,479027,12002,1271471
5286,18215,61989,28950,17957,68186,28950,224247
8527,27238,28915,1688,26080,27484,1688,113093
6388,16821,39961,13382,17341,40031,13382,140918
8836,1657,829,0,1557,835,0,4878
2199,34207,46167,1093,35686,53807,1093,172053
1699,5221,667,1752,5486,683,1752,15561
7379,239,21,0,61,22,0,343
4535,16417,17611,145,15986,17649,145,67953
9997,35441,16348,11416,48003,16348,11416,138972
9175,566,97,0,437,97,0,1197
2666,2543,2411,255,2516,2407,255,10387
1548,220209,680444,901484,198004,706832,901484,3608457
1562,14800,57375,13893,14615,59858,13893,174434
3252,1222,69,354,1854,64,354,3917
2672,23340,35413,4773,22689,35999,4773,126987
3534,43398,63526,2341,43920,63405,2341,218931
2002,7065,1879,4162,8317,2164,4162,27749
3590,563,38,137,443,39,137,1357
3592,1487,1067,45,1279,1068,45,4991
3536,439,563,0,565,564,0,2131
5914,22917,22803,22696,23799,23229,22696,138140
3537,8551,17824,471,8706,17793,471,53816
3586,8736,4515,1304,9025,4515,1304,29399
2341,61422,116499,4346,64707,118777,4346,370097
2340,26702,36808,8534,26362,37072,8534,144012
5290,4640,4117,2925,2320,7089,2925,24016
3538,30982,59386,368,28613,59157,368,178874
5751,4162,6046,2326,4301,6045,2326,25206
6973,36977,31856,92655,22670,31707,92655,308520
5059,21589,17433,76700,13138,17899,76700,223459
3572,181,176,0,204,177,0,738
5239,45405,127824,45777,41106,122228,45777,428117
6821,35168,35141,44740,33998,37741,44740,231528
5604,53347,91720,158065,35810,97584,158065,594591
5073,58175,110991,238917,49375,119140,238917,815515
2248,32375,59256,376,33540,75650,376,201573
6110,33410,78463,134393,29664,85156,134393,495479
1268,133442,244117,78224,133040,243628,78224,910675
5670,131281,305461,255202,132541,312115,255202,1391802
6528,3789,8632,2413,4523,8553,2413,30323
6287,4692,43,367,4279,50,367,9798
2983,48674,96226,58379,46260,101176,58379,409094
6968,10068,9601,12086,10882,9643,12086,64366
6140,17831,57661,16435,20385,58116,16435,186863
7458,54306,57275,222987,41351,64535,222987,663441
2159,179,14,119,426,14,119,871
6833,21037,33901,71513,18374,40803,71513,257141
6834,521334,175465,41794,523620,172931,41794,1476938
5228,28404,91427,209497,21894,99760,209497,660479
3250,24562,3583,4037,21903,3556,4037,61678
8221,30945,26934,8370,29395,26938,8370,130952
3413,4613,5018,15474,5874,5024,15474,51477
1977,3466,3084,303,4987,3091,303,15234
1043,23836,24011,46,24685,24031,46,96655
8469,65155,49564,15672,65552,49008,15672,260623
9842,24001,20394,8554,30484,20394,8554,112381
6092,275615,550343,431806,249720,564954,431806,2504244
9553,19851,15502,5731,21421,15514,5731,83750
1386,765,3316,970,665,3297,970,9983
9554,26834,25658,23778,30006,25651,23778,155705
9888,239761,260498,97976,234310,260261,97976,1190782
2771,244206,650909,100174,234625,647281,100174,1977369
7513,12577,5452,4324,14063,5460,4324,46200
8451,4441,5015,21,5070,5055,21,19623
7975,9539,9815,1563,11097,9911,1563,43488
1467,14489,30366,39159,15377,30499,39159,169049
6934,16311,24119,77465,19469,24253,77465,239082
1314,162884,401905,50795,161835,399303,50795,1227517
5248,6676,5671,22025,4810,11038,22025,72245
1316,7763,1548,1742,7601,1621,1742,22017
1454,40109,65630,86958,25699,68432,86958,373786
5240,6555,15233,58866,4659,18190,58866,162369
8964,38267,39820,25438,50779,39786,25438,219528
4770,15530,25178,6549,16107,25272,6549,95185
5606,50429,79082,147754,36455,92049,147754,553523
4646,55648,88837,10114,54020,88050,10114,306783
4643,40397,53461,23940,40554,55834,23940,238126
7355,51028,53942,54455,53597,53732,54455,321209
9555,6754,17148,0,6852,17229,0,47983
6969,155809,428581,627069,154990,418471,627069,2411989
4558,42360,156050,22598,41093,153243,22598,437942
8673,1862,1639,0,2296,1640,0,7437
5607,48617,88848,85515,33561,92035,85515,434091
5383,50672,81595,235308,27971,92392,235308,723246
5384,99417,190539,416192,67789,207121,416192,1397250
5435,74988,171896,299425,42300,181355,299425,1069389
8543,7878,3624,11,4069,2853,11,18446
2834,506,1138,34,454,1265,34,3431
8674,342,85,0,346,83,0,856
5191,66396,139155,87879,58259,142847,87879,582415
4771,32420,67326,12637,34404,67393,12637,226817
5029,6509,9570,10213,5973,9609,10213,52087
2868,157,115,28,234,117,28,679
1483,1286,426,86,807,463,86,3154
1484,2150,847,3650,2618,947,3650,13862
7098,5082,34717,29684,4214,36957,29684,140338
4157,30,18,0,27,18,0,93
9959,12415,13204,2715,14795,13203,1340,57672
5608,29043,79594,70851,25722,87745,70851,363806
7640,261307,292476,22574,228834,340797,22574,1168562
5155,17486,19327,90543,8898,22293,90543,249090
5671,48465,99403,86079,43157,105569,86079,468752
5675,2258,3251,3394,1989,3747,3394,18033
5571,342960,803904,927972,254127,841094,927972,4098029
1861,10343,19328,7747,11101,19287,7747,75553
1044,79052,107315,5242,86132,107518,5242,390501
5436,5216,3852,8633,5005,7041,8633,38380
5385,258874,564027,772806,227186,555508,772806,3151207
5249,692,446,67,707,439,67,2418
5075,63359,203703,330103,48099,223085,330103,1198452
5156,11890,28572,31473,6744,34275,31473,144427
4222,157359,411972,43689,146888,410329,43689,1213926
5920,34333,37311,50030,36835,37780,50030,246319
5884,8261,17021,10980,10271,17642,10980,75155
5933,9905,13332,13876,10945,13184,13876,75118
6355,1770,264,146,2815,259,146,5400
3333,240118,421749,263353,246771,420963,263353,1856307
6228,288,36,139,276,36,139,914
6686,29754,63509,9010,28392,60468,9010,200143
2800,8740,22502,5471,7977,25051,5471,75212
5085,21721,42963,91582,10577,50527,91582,308952
5437,77254,147037,309824,46047,159020,309824,1049006
5609,16891,15948,5510,23153,14247,5510,81259
1900,42208,1614,16738,36514,1654,16738,115466
3195,3014,3026,4453,3677,3054,4453,21677
5386,9502,12575,24928,4854,15793,24928,92580
3880,25050,34605,21572,27365,34600,21572,164764
8676,2103,1160,0,2009,1162,0,6434
2463,721,56,0,701,56,0,1534
4479,968,1083,10,872,1090,10,4033
4355,4299,2283,166,4860,2648,166,14422
1010,20996,35793,244,18624,35844,244,111745
1322,50671,79036,63401,60266,81422,63401,398197
3151,13893,19216,22281,14840,22200,22281,114711
5387,4091,18728,13510,2955,20049,13510,72843
3471,70913,236099,19135,70830,235412,19135,651524
8727,1871,910,0,2543,914,0,6238
5572,114526,208553,231580,73995,225354,231580,1085588
7521,9,9,0,25,12,0,55
3430,23104,64488,54428,25931,64518,54428,286897
4691,81892,216875,23827,84508,219969,23827,650898
5837,4302,15267,5331,4126,15499,5331,49856
4110,10732,19223,128,10915,19262,128,60388
5193,9795,19716,38294,12665,24193,38294,142957
5610,26146,43767,49805,23061,47329,49805,239913
3152,42926,50077,77433,44080,52039,77433,343988
2264,11330,24548,355,10339,25630,355,72557
4523,13809,22194,20,12657,21842,20,70542
4538,2805,1460,1035,2886,1746,1035,10967
3153,37250,18659,52706,45675,20329,52706,227325
6949,23010,27301,63309,16859,27285,63309,221073
7203,10952,24234,5020,11808,24401,5020,81435
8191,17280,27057,21425,18673,27166,21425,133026
7976,30317,34821,10613,33779,34920,10613,155063
6530,21743,54412,18418,23241,53784,18418,190016
6531,35,30,0,43,36,0,144
5849,358,588,57,383,591,57,2034
9812,19770,13402,4894,22926,13402,4894,79288
6210,387,5,293,494,5,293,1477
5388,72001,183511,345906,42013,193000,345906,1182337
9825,4513,2464,1836,4515,2464,1836,17628
7460,31135,69712,217282,26913,72828,217282,635152
6267,286,26,87,337,25,87,848
6857,5099,19818,29464,5219,20196,29464,109260
5491,120283,289712,408088,109921,304816,408088,1640908
5028,553,2110,1256,1376,2250,1256,8801
6203,513,29,5,702,29,5,1283
8282,7043,17320,2379,7330,17386,2379,53837
8677,5410,12578,0,5003,12597,0,35588
7356,5895,931,685,4795,932,685,13923
7461,77,631,42,518,635,42,1945
7462,53360,75833,77855,47063,78026,77855,409992
1035,14635,27145,1222,15544,27125,1222,86893
3154,28916,26775,78303,34462,28483,78303,275242
2985,1,10,0,1,10,0,22
1159,19697,28818,506,18968,28949,506,97444
4025,3790,12357,4066,4270,12359,4066,40908
5798,17893,29985,19646,16336,31888,19646,135394
3474,19781,55123,13026,20611,54457,13026,176024
2677,40009,54920,12685,43577,55872,12685,219748
5573,22738,32572,35212,22638,35782,35212,184154
3897,12037,30107,6853,14438,30106,6853,100394
5229,185443,500110,913285,164803,495039,913285,3171965
4271,4839,7980,1829,4504,7980,1829,28961
4432,101,116,0,72,126,0,415
3882,13060,39700,7705,14781,39705,7705,122656
5389,20815,29357,57200,8894,33505,57200,206971
5758,12578,25148,8684,12902,24054,8684,92050
3434,19711,104479,9410,21319,104397,9410,268726
3432,9645,7070,34401,8425,7078,34401,101020
3558,23055,97223,26881,24638,96844,26881,295522
5921,17309,25843,31463,19741,26823,31463,152642
2283,33250,38542,17026,34001,38609,17026,178454
2969,6316,4836,2189,6149,5248,2189,26927
3887,85057,153056,32985,69634,153000,32985,526717
3886,2645,149,2649,3217,146,2649,11455
3888,3957,10239,1881,4235,10245,1881,32438
3889,9931,32858,13225,8375,32866,13225,110480
3891,18591,44899,9300,16761,44926,9300,143777
7225,4218,2910,1265,3292,2922,1265,15872
1393,32590,68938,123881,22196,86908,123881,458394
4276,3673,8901,17183,3539,8902,17183,59381
9562,88277,91109,48745,99297,91139,48745,467312
3348,56329,77198,36455,57835,77203,36455,341475
3540,105262,157300,8919,101779,155921,8919,538100
8837,577,186,0,528,186,0,1477
5390,50737,62754,189202,27146,74370,189202,593411
5230,157423,488199,643709,140787,510535,643709,2584362
6952,21692,20712,61178,18675,20790,61178,204225
1783,12669,7310,3055,12287,7655,3055,46031
5574,173529,405390,323152,147053,417588,323152,1789864
3155,90809,159876,188552,79919,174155,188552,881863
2439,512,906,660,612,979,660,4329
3817,10360,7070,9261,8934,7063,9261,51949
4357,167,70,0,183,99,0,519
8728,1375,766,0,1457,773,0,4371
4518,23315,11560,2113,22058,11369,2113,72528
4433,12323,18127,13437,12468,18037,13437,87829
5334,5779,15045,23944,4536,16493,23944,89741
9776,101890,73092,41926,104086,73092,41926,436012
6211,3334,16,2003,3356,15,2003,10727
8261,1635,49,2459,1526,49,2459,8177
2010,21021,48364,6396,22885,49029,6396,154091
5826,1688,2332,5054,2330,2337,5054,18795
4504,134802,216980,5845,117524,215652,5845,696648
9373,37866,19228,20044,40466,19222,20044,156870
2364,4388,2003,477,4317,1974,477,13636
7464,319722,305381,815836,255100,300868,815836,2812743
5613,6280,9508,25205,8186,9885,25205,84269
1524,9355,4861,1316,9120,4933,1316,30901
8838,14,26,0,12,29,0,81
5391,34951,56168,152895,26026,59544,152895,482479
2141,8719,1529,226,8873,1551,226,21124
5967,5609,8826,3069,6214,8876,3069,35663
2938,19633,36872,10497,15904,38045,10497,131448
1342,23183,15488,9166,24236,15927,9166,97166
2440,2196,1525,2848,1924,1527,2848,12868
5597,66892,152162,117677,29470,87381,117677,571259
5676,40024,74580,66960,32558,83777,66960,364859
5392,22241,26007,53031,20470,25380,53031,200160
5393,66,284,11,187,350,11,909
5231,17294,56904,112171,13309,64997,112171,376846
6268,11675,996,16025,13298,1001,16025,59020
8584,115,195,0,179,196,0,685
8591,287252,352665,45243,286839,362654,45243,1379896
2612,17838,25937,10408,15765,28271,10408,108627
2154,29746,53048,768,35477,68461,768,188268
2265,29861,47833,919,22040,37276,919,138848
5394,74972,147556,237657,58177,148136,237657,904155
9365,17300,5192,6759,16642,5194,6759,57846
5041,16240,30095,51197,15599,32540,51197,196868
1216,61002,152163,1700,66526,152627,1700,435718
2665,13171,10024,7158,12723,10584,7158,60818
6823,58194,49315,170914,49992,49587,170914,548916
6953,96392,506046,1128383,62332,502981,1128383,3424517
7407,8102,5605,1689,10240,5844,1689,33169
2251,13439,20367,1576,12988,19038,1576,68984
6858,3097,35639,14168,2959,36194,14168,106225
5575,132564,260368,352063,115171,277758,352063,1489987
5639,3025,7200,7551,3003,11366,7551,39696
5395,71212,126718,167953,46309,137221,167953,717366
5372,4663,5121,1914,4172,6346,1914,24130
5576,53942,62693,128894,38621,70450,128894,483494
7408,6965,3818,1992,7868,3907,1992,26542
5264,7197,4887,12664,8429,5409,12664,51250
6824,71851,82162,113766,60368,85790,113766,527703
5959,31200,81745,25115,28616,85088,25115,276879
3158,6377,11079,10005,6869,14855,10005,59190
5505,25902,60122,15106,29750,60423,15106,206409
5316,214,326,435,246,710,435,2366
2384,149961,256180,38319,226922,257671,38319,967372
2390,91505,88570,32633,36022,87838,32633,369201
4600,57058,68381,21227,60428,67664,21227,295985
2965,2,7,0,2,7,0,18
1121,4250,8574,3217,6107,8634,3217,33999
7079,8396,8681,17872,14342,9764,17872,76927
5241,5015,11517,9128,4321,13137,9128,52246
5158,42588,141880,1249,21027,34355,1249,242348
2133,78430,144215,2760,92640,191059,2760,511864
1455,18224,118701,44285,25021,108758,44285,359274
1402,287430,798012,534317,261897,794983,534317,3210956
1403,5409,8776,14987,6696,8362,14987,59217
1401,8,23,0,9,23,0,63
1456,9,13,0,9,18,0,49
7057,3847,7534,3115,7806,7845,3115,33262
6095,5948,5224,20660,7446,6122,20660,66060
3796,2821,3606,2015,3244,3601,2015,17302
1357,2603,1155,4746,2242,1155,4746,16647
6859,127,3078,3394,1749,4350,3394,16092
8509,9886,8185,6440,10920,8177,6440,50048
6073,11148,9036,18581,14930,10227,18581,82503
5128,81684,118414,602011,41431,139659,602011,1585210
1940,50076,66621,103209,53915,66813,103209,443843
4690,38775,98423,23716,39490,99037,23716,323157
4434,10326,13006,845,11535,13169,845,49726
6183,176439,245935,256210,160550,247918,256210,1343262
6096,31346,44938,102464,27427,49365,102464,358004
1347,12205,19132,4196,13081,19162,4196,71972
1423,76787,206246,113398,55153,207546,113398,772528
1509,8903,55548,3584,15533,55607,3584,142759
9673,35933,21984,6486,40393,21986,6486,133268
1466,23290,59458,46979,23067,60401,46979,260174
2681,723,386,41,746,384,41,2321
2266,5580,6367,404,4196,5638,404,22589
5684,73824,140465,211108,67141,150386,211108,854032
9250,18059,10974,8828,20012,10976,8828,77677
5411,68656,129389,87944,14252,74931,87944,463116
3174,39577,126713,93749,34893,133628,93749,522309
5086,36164,82720,138998,15690,94204,138998,506774
3188,19204,37632,72186,12311,43094,72186,256613
1525,26909,63355,198645,5377,45429,198645,538360
1421,37196,63693,59991,62025,84922,59991,367818
7466,16659,17152,70440,17196,19008,70440,210895
9564,25212,19864,12450,27111,19876,12450,116963
2201,41808,96029,722,41234,103070,722,283585
5129,26889,61245,98020,23067,69983,98020,377224
5438,42130,112182,164032,22485,121075,164032,625936
3059,0,4,0,0,4,0,8
7329,1131,1235,180,1397,1253,180,5376
5242,8749,14815,22791,8116,14167,22791,91429
5293,12469,9039,22275,5946,12384,22275,84388
5054,37861,39460,175542,20853,50322,175542,499580
5278,23196,71933,55480,19665,76746,55480,302500
5712,35510,56879,19164,40081,57134,19164,227932
7476,43439,87241,162386,52104,91819,162386,599375
5151,62713,97756,213767,23703,107012,213767,718718
5030,832,2148,7023,687,2720,7023,20433
9231,6270,2700,1495,7724,2697,1495,22381
7226,1273,623,655,1296,624,655,5126
9998,122892,79763,48137,119071,79764,48137,497764
5195,5052,18822,12017,4834,19081,12017,71823
2619,10713,14426,4915,8760,16139,4915,59868
3388,4039,1998,1806,4164,2150,1806,15963
3391,60732,187935,51013,61086,188653,51013,600432
7572,3006,1447,88,3545,1449,88,9623
5577,145383,234871,419948,141321,242732,419948,1604203
5965,39800,235296,40057,37431,233081,40057,625722
2772,12489,26991,7278,12060,26982,7278,93078
2736,9192,12341,2462,9848,12502,2462,48807
1585,4833,4909,110,4958,4906,110,19826
9753,37525,23979,6982,41101,23978,6982,140547
5759,3394,5707,5376,4586,5732,5376,30171
9665,6416,4760,1372,7418,4761,1372,26099
2161,16051,23465,1155,13173,22483,1155,77482
8184,11386,21899,46701,10898,21916,46701,159501
3896,3425,6113,1527,3153,6115,1527,21860
5527,9538,12711,35481,9315,14119,35481,116645
1348,9029,13439,5248,10432,13511,5248,56907
6956,32796,61661,57392,33592,61429,57392,304262
6846,72,1126,4705,2114,1291,4705,14013
9777,52255,33948,20987,51755,33947,20987,213879
2885,8,40,5,15,40,5,113
2048,38266,33565,5818,39939,33646,5818,157052
4111,6648,9810,1966,6936,9824,1966,37150
8130,531,24,0,416,23,0,994
4539,1472,2786,0,2385,2904,0,9547
5196,25439,81573,156470,24334,85759,156470,530045
7187,2032,577,2192,2356,609,2192,9958
7047,12887,12617,60778,12881,13878,60778,173819
5611,51779,95847,123554,33481,100196,123554,528411
5396,14877,29923,42747,11023,32187,42747,173504
5439,6059,10697,19749,6631,11600,19749,74485
8680,2654,4884,0,1997,4865,0,14400
6891,93968,206248,590713,92703,208309,590713,1782654
7227,4318,1846,106,4164,1842,106,12382
7695,1097,105,689,550,105,689,3235
2391,39169,31221,13679,41689,31280,13679,170717
4528,33108,36771,1247,29518,36857,1247,138748
2363,172005,333717,64384,191629,347726,64384,1173845
2406,35885,106759,24459,15630,96991,24459,304183
2098,8541,10957,3005,10106,10958,3005,46572
3965,1690,2989,867,1803,2988,867,11204
1457,78754,146875,107204,48662,149694,107204,638393
9781,51283,33236,59336,52210,33233,59336,288634
1905,3615,3394,1001,3137,3467,1001,15615
4568,5709,1932,284,6682,2246,284,17137
2774,90362,111451,37467,92113,111498,37467,480358
1056,4888,2261,5994,5984,2466,5994,27587
5578,704532,1367387,1747147,423811,1394209,1747147,7384233
5612,4705,3890,3065,4668,5517,3065,24910
5042,250,1713,688,413,2037,688,5789
5924,187449,484862,450473,184750,489160,450473,2247167
5528,17053,30308,64712,14654,33710,64712,225149
6024,39575,40580,190609,23779,41245,190609,526397
1978,31224,78961,3239,29908,78405,3239,224976
3175,105543,293384,107352,103524,294015,107352,1011170
5672,52982,250312,54665,48562,250300,54665,711486
5697,40049,42647,74996,43822,44016,74996,320526
5698,30954,24365,28024,32433,24812,28024,168612
2269,7890,16757,1509,9296,16894,1509,53855
9694,25060,17772,10144,29345,17778,10144,110243
6844,57005,249871,538239,54223,261446,538239,1699023
5640,14364,16326,52376,12268,20768,52376,168478
1011,9281,30391,218,13503,30461,218,84072
5341,22173,62202,148665,19596,65481,148665,466782
6860,7671,39371,71245,6227,40734,71245,236493
1539,7370,12451,12585,6230,13799,12585,65020
5685,417755,901878,954062,399197,925730,954062,4552684
5696,190663,267599,249049,197126,273711,249049,1427197
5440,16532,29408,36103,15592,30778,36103,164516
1218,242607,606438,71674,250476,605833,71674,1848702
1364,8442,18168,55162,9025,21769,55162,167728
6688,14708,29188,4783,16373,28243,4783,98078
4536,2533,1782,348,2978,2201,348,10190
6954,31315,34498,86504,20831,38398,86504,298050
7228,14023,10799,4093,14612,11055,4093,58675
7467,5433,3268,6456,6416,3236,6456,31265
9639,8552,6501,1118,8126,6501,1118,31916
6892,18261,42430,231442,17580,46351,231442,587506
6732,1897,2191,437,2182,2079,437,9223
2988,0,1,0,0,1,0,2
8578,28801,13392,1973,23752,11524,1973,81415
2835,5088,4409,2008,4249,5004,2008,22766
5441,8643,11051,54946,3929,12989,54946,146504
5055,229,48,97,197,249,97,917
2773,12664,16684,12726,13312,18711,12726,86823
5960,17857,38037,18064,18699,39346,18064,150067
5925,10972,9123,14012,11425,9866,14012,69410
5152,134843,362249,500710,85444,365471,500710,1949427
5153,19896,29370,77076,10900,33714,77076,248032
4540,1315,1708,246,1759,1877,246,7151
4893,46241,92340,96155,20913,71877,96155,423681
5579,63180,111749,316103,47057,123060,316103,977252
4891,181182,213834,111472,203540,227186,111472,1048686
2040,36499,24241,19247,37275,24246,19247,160755
6574,41367,44470,20446,42020,44498,20446,213247
3390,9572,5910,5089,9686,6214,5089,41560
5686,9131,5314,34264,8764,6288,34264,98025
7326,2686,1331,934,3309,1338,934,10532
5279,98290,465273,179119,95215,472502,179119,1489518
6907,323,1408,3979,537,1696,3979,11922
5673,3000,3743,3559,3350,6844,3559,24055
1350,1688,1732,5,1876,1727,5,7033
8123,224,104,219,114,105,219,985
4486,374,1046,71,901,1094,71,3557
4487,90344,61348,6477,87768,61458,6477,313872
7327,9606,12210,2169,10089,12944,2169,49187
5031,10788,33005,18254,10129,34661,18254,125091
7514,18189,13868,4734,19242,13840,4734,74607
1138,35119,35128,592,35794,35224,592,142449
7383,3483,3491,787,4327,3486,787,16361
4532,5598,5259,422,5396,5489,422,22586
5232,3928,5906,2588,4489,6249,2588,25748
4537,34349,34630,1746,32449,34775,1746,139695
7917,19228,10869,2970,21240,10884,2970,68161
7328,50251,130613,10291,53433,130646,10291,385525
3380,23925,10145,16961,23749,10233,16961,101974
3392,31381,29348,27758,33238,29612,27758,179095
5827,1794,1582,1482,2059,1584,1482,9983
5838,11280,51029,4172,11158,51970,4172,133781
5856,11681,27097,1122,11236,27836,1122,80094
5857,1290,1653,168,1408,1650,168,6337
3818,3133,7381,3020,2722,7380,3020,26656
9990,23911,14227,9028,27322,14226,9028,97742
8263,557188,1163576,359044,546984,1162123,359044,4147959
1351,1115,1311,10,1075,1361,10,4882
4026,18215,42056,20799,19710,42059,20799,163638
3871,10253,27225,5343,11467,27222,5343,86853
,,,,,,,
,,,,,,,
