NLC,Entries & Exits_Full,Entries & Exits_Reduced,Entries & Exits_Season,1617 Entries & Exits,1617 Interchanges
5131,667244,728894,1592664,2988802,
3813,93706,5530,128034,227270,
3801,156760,12790,124088,293638,42087.4638
3982,327512,33910,207942,569364,
8976,1025658,1571606,461004,3058268,192344.0287
9090,37890,61132,26186,125208,
4435,24068,11892,0,35960,
4440,1434,706,0,2140,
3602,211404,127306,87120,425830,
2448,29288,30066,9278,68632,
4303,141966,183790,1578,327334,0.7516
2552,193772,170308,96392,460472,
8600,342,82,0,424,
8601,1730,1346,0,3076,
8602,572,306,0,878,
7662,152,52,0,204,
7286,15032,22896,9786,47714,
4529,121906,150804,195546,468256,
2287,10932,4924,4236,20092,
1404,537352,721522,672990,1931864,
3000,69246,63286,106004,238536,
1036,20440,22786,39178,82404,
9310,5832,10080,4590,20502,
5550,142346,101100,185758,429204,
5160,5450,7496,8272,21218,
2939,14262,11948,4106,30316,
2641,37410,39594,45510,122514,
8353,92204,58224,47498,197926,
2255,196866,320092,295624,812582,
2350,217938,571934,233638,1023510,
2125,213270,424696,410648,1048614,
9695,33820,62024,47086,142930,
9759,251560,488628,346056,1086244,
5132,256520,221368,488838,966726,
4614,27124,34088,38168,99380,
2760,115680,105816,63308,284804,
3145,21276,33748,33964,88988,
5623,430796,542802,464016,1437614,138886.0185
5280,41928,71066,72880,185874,
6025,438068,604790,578806,1621664,55829.7005
9905,63340,177132,81792,322264,
9861,62340,138420,106588,307348,
1805,124896,130658,36576,292130,
7520,29454,20826,15134,65414,
9883,94672,193676,72248,360596,
8605,19888,5032,1456,26376,
7787,83980,201638,26834,312452,1066.3877
6847,12896,17222,39602,69720,
1223,61264,27272,22480,111016,
6869,8766,7510,28262,44538,
6532,2666,5874,2162,10702,
8606,316,40,0,356,
5544,166786,236656,312720,716162,
2806,117200,157538,293996,568734,272.4682
1198,68194,32384,87958,188536,
1678,18444,21266,7180,46890,
5250,9800,24484,16312,50596,
506,845034,902306,211526,1958866,
4236,12758,6390,280,19428,
6358,3766,960,2436,7162,
9965,131698,161070,368514,661282,
5510,237432,509654,478816,1225902,1121.4493
5397,258736,386864,327412,973012,
6909,13300,6448,13796,33544,
5267,117728,340190,242060,699978,
9451,8086,113922,2390,124398,
9972,250764,596338,370920,1218022,
2662,15034,20446,5048,40528,
8562,150506,122482,77324,350312,
2052,38328,21890,1228,61446,22489.8615
5003,5032,11702,19152,35886,
3109,1668,3174,1584,6426,
2396,48196,129604,68806,246606,
1430,171344,178224,284916,634484,
9079,131198,167426,62414,361038,1185.425
8613,5670,928,546,7144,
9962,2492,2934,0,5426,
9453,62830,57610,564,121004,
9569,47616,115170,61680,224466,349.1516
9455,5484,11892,6810,24186,
2960,642,196,22,860,
9961,249494,862016,301680,1413190,
8821,3442,2820,0,6262,
6171,176176,228308,289064,693548,
990,70522,87156,81010,238688,
2054,1054,1106,20,2180,
1963,34696,64574,11340,110610,
8045,208,822,476,1506,
9963,9542,4450,1750,15742,
5251,33348,136954,102380,272682,
5666,431402,576392,239284,1247078,308004.6472
3003,2884,228,1532,4644,
5641,75446,87152,116646,279244,33872.9547
5547,120100,126776,233978,480854,122402.2578
2941,36732,25622,36118,98472,
4700,32906,38490,22848,94244,
9953,11014,33020,6306,50340,
5667,269650,257518,530172,1057340,
5004,584002,1540948,1673536,3798486,818551.648199999
2850,3026,3754,1900,8680,
5347,322744,354580,639960,1317284,
2790,115874,144426,126420,386720,
5398,4738,7228,10662,22628,
5906,32092,44730,54770,131592,
6083,30808,23630,95946,150384,
1953,26720,16336,22696,65752,
6233,9670,10044,10858,30572,
2095,10272,11202,4430,25904,
1380,2198,3764,3492,9454,
1004,111772,161446,252088,525306,50369.5815
1074,50362,51710,41404,143476,
2584,78152,103508,156504,338164,
8608,596,342,0,938,
1624,64516,11876,29350,105742,
7367,47848,73628,37990,159466,
9457,21626,31484,8728,61838,
7017,176396,308916,445648,930960,7240.4786
2215,44368,89740,66496,200604,
8610,59436,82414,3350,145200,49.7181
3265,9656,9714,1646,21016,
3200,98474,8468,37168,144110,
5714,44598,266524,84094,395216,
1492,316304,404922,455420,1176646,4813.7208
1090,35524,34886,98754,169164,
5162,34016,31976,56562,122554,
5197,24608,33386,30758,88752,
9463,442126,886998,305426,1634550,77162.5289
2187,128694,188524,42882,360100,
4186,14362,4156,5258,23776,
5681,61030,48560,50486,160076,
8552,111832,74152,103960,289944,
9763,41894,65656,48930,156480,
5492,22298,38984,66784,128066,
6084,181304,231604,235830,648738,
5399,1680652,2549906,4520198,8750756,401168.9699
9862,112114,306526,124366,543006,
9013,170,46,1148,1364,
2561,40882,31170,17624,89676,
2820,14124,14292,2098,30514,
8839,1770,4082,0,5852,
4502,637152,1174008,677600,2488760,289088.653100001
2471,182092,432276,42682,657050,1125.1616
2238,39042,77842,51566,168450,
5348,46502,36348,59278,142128,
9466,41674,83042,49102,173818,
7563,3314,5490,2480,11284,
2690,70462,48302,60742,179506,
9764,30712,54872,29328,114912,
4011,132414,11230,71410,215054,
7492,3243708,4718146,4824688,12786542,548809.2956
5133,35096,42058,65696,142850,
4445,107040,50276,28270,185586,
5089,368278,436954,953234,1758466,
5551,679262,807286,1174736,2661284,23208.7816
5580,257614,268124,369638,895376,
6406,13136,42360,7604,63100,3984.0275
5252,152532,303772,447920,904224,683524.8115
9973,18364,34666,12828,65858,
6774,581816,555878,341084,1478778,29065.3872
5725,18280,368718,56452,443450,
1096,90996,70762,123578,285336,50896.4984
9674,160782,247610,329734,738126,
9467,3256,10234,62,13552,
6212,1028,498,0,1526,
1954,232670,321182,99458,653310,17566.3539
1903,26654,22522,38616,87792,
3805,310476,35612,186514,532602,4206.3007
3806,143602,10722,69922,224246,
3807,286228,43870,381714,711812,
9020,22,2,0,24,
6207,25168,12438,2178,39784,
7494,980438,716666,1483074,3180178,
5520,1248198,2220790,2225966,5694954,925376.988000004
5090,27804,28800,45752,102356,
3271,1289820,4039654,1102860,6432334,196907.3009
9311,352180,542302,408304,1302786,
8484,133852,129980,87334,351166,
7909,1060,600,0,1660,
5420,375676,529174,877710,1782560,6145.9426
5215,88246,248422,223228,559896,
6870,4170,5100,7534,16804,
6006,14184,19744,16218,50146,
3047,392188,466852,739210,1598250,
2420,290,276,230,796,
9966,143042,248212,164736,555990,
5091,54258,128282,208274,390814,
8822,212,100,0,312,
5890,2548,4930,1380,8858,
8877,28656,23350,864,52870,
2188,342580,315932,195876,854388,
7258,26680,69358,13868,109906,
5076,96090,108834,124866,329790,
5046,663246,799042,1314816,2777104,77134.4334000001
1512,545108.008457004,1786841.22057329,1609414.45505184,3941363.68408213,53451.9371
1510,25423.9915429965,83338.7794267128,75063.5449481602,183826.31591787,
5538,38006,34484,44594,117084,
3245,40640,27904,25200,93744,
1165,50744,16642,17924,85310,
3070,13816,72964,33754,120534,
1625,259338,176720,98614,534672,84844.0067
5198,6452,9870,9966,26288,
2785,4006,5368,2082,11456,
9895,156038,360476,157462,673976,26210.5118
5062,178558,198016,404878,781452,
9714,185606,319424,347180,852210,60782.3349
5350,40016,21138,75616,136770,
1679,73490,114170,42584,230244,1203.256
5227,2950,2592,5772,11314,
5092,277208,279376,480104,1036688,
8047,3950,7266,1630,12846,
8564,96392,101706,32290,230388,
7439,1031038,777854,2035474,3844366,
2676,11878,11590,162,23630,
5624,31994,26442,83270,141706,
8352,59656,34516,36262,130434,
3549,3322,24840,12816,40978,
3550,942,10636,4422,16000,
1390,499706,594084,680068,1773858,
1045,57946,93972,165246,317164,
6543,11740,4668,3698,20106,
7330,642,422,62,1126,
8431,11326,9314,9676,30316,
5581,107120,126544,141082,374746,
5323,11552,31972,26198,69722,
7791,20538,497856,21384,539778,1292.6212
2351,1430,2166,392,3988,
1003,29312,55370,74158,158840,
5472,4036,5064,6132,15232,
6961,293412,440712,522252,1256376,
2449,20050,16164,72,36286,
8048,123652,353378,196046,673076,9.5262
5211,162410,411720,632916,1207046,
5093,316830,315026,515256,1147112,
5094,749156,836448,1484594,3070198,
3048,194862,354924,373614,923400,39867.9146
3104,102364,1009666,199208,1311238,56.9882
5063,290970,296694,351466,939130,3937.3233
2136,99974,102620,84486,287080,88535.0745
6170,236428,349704,442954,1029086,
4618,35194,30750,60244,126188,
6871,598062,591750,1881122,3070934,
7910,48452,33282,13260,94994,
5464,72428,144728,201410,418566,
6235,22172,30354,14690,67216,
8553,428480,533040,293132,1254652,
3907,31578,2896,21852,56326,
5163,33224,88106,256182,377512,
2304,317728,189306,205528,712562,
5401,26318,23328,33016,82662,
2352,164530,629030,241440,1035000,
2217,319586,393500,220748,933834,
2219,629412,787940,523494,1940846,190816.7948
2145,375154,205946,175268,756368,48087.0428
2220,285922,252088,154444,692454,
4513,1042,12616,1434,15092,
1215,1931714,2951584,1584736,6468034,104487.0866
4515,1447736,2494182,2861168,6803086,421088.416699999
1127,8541270,16779516,17045990,42366776,5791186.75330005
1006,752974,1187070,2510830,4450874,279065.751
7835,49444,55608,13690,118742,
9940,105254,368240,107928,581422,
6800,700482,946442,1518226,3165150,79203.0315
5402,4844,12364,3112,20320,
9620,134526,250486,236042,621054,
5945,32470,30550,26778,89798,
2737,488448,537086,252396,1277930,95187.2434999999
5112,2548414,2915748,5111884,10576046,830376.978799999
5095,839504,1144402,1485086,3468992,41831.0747
7400,199730,307402,267088,774220,
2739,574342,1172844,111608,1858794,4291.7402
2738,35366,68494,1606,105466,
2740,55092,62586,9852,127530,23.6404
991,19234,19170,18490,56894,
2732,36498,34664,537988,609150,
5625,134554,243500,148228,526282,
2450,17234,23476,0,40710,
8750,5410,11952,236,17598,
9760,101520,168008,213426,482954,
1176,97356,103266,179594,380216,
4574,19564,11478,64122,95164,
9716,130916,256768,179886,567570,
7503,5052,3472,6604,15128,
6204,5834,738,236,6808,
1360,144344,401768,535616,1081728,100865.1042
1141,24120,25552,0,49672,
1018,24776,26466,58,51300,
2123,307840,777340,385032,1470212,
1282,44474,26612,24832,95918,
3501,16020,200782,19388,236190,
2435,2736,1948,272,4956,
5253,156786,514402,300660,971848,
9668,9350,14378,15070,38798,
2599,836832,1069356,1333948,3240136,512245.1054
8536,27186,27884,19694,74764,
5626,96886,102010,132886,331782,
1993,6520,3864,1466,11850,
2195,234964,517520,230108,982592,96.248
2239,147230,232302,258076,637608,
5130,75794,163106,202034,440934,
4304,45984,17988,526,64498,
5254,15768,23998,23310,63076,
6216,80280,115188,16356,211824,
5894,44008,49130,70698,163836,
6237,23826,18918,22720,65464,
3018,58204,71458,127494,257156,87907.1395
5876,661338,1715770,378664,2755772,69627.0589999999
1112,235764,407092,524448,1167304,
1381,6250,8046,26330,40626,
6027,154120,128638,586820,869578,
9968,7774,16778,9886,34438,
5403,21068,46716,30070,97854,
5693,880848,707958,765764,2354570,33.3973
8346,768512,831516,512866,2112894,46205.8246
8345,821944,1433962,720146,2976052,77119.6184
3341,207610,234984,100652,543246,3810.1492
5530,34696,4336,9468,48500,
6801,109300,203666,475040,788006,
2053,23152,40586,18960,82698,
2944,74726,92310,135876,302912,
5500,59784,126606,104542,290932,
8496,135614,111274,99086,345974,
7565,7192,7288,3228,17708,
7259,2348,4096,1398,7842,
9938,29818,56710,26672,113200,
7200,40912,46426,25332,112670,
5875,91570,121704,78258,291532,
2045,590,366,0,956,
2779,55298,68310,90892,214500,
9251,36,12,0,48,
5552,575310,455142,827156,1857608,
6872,929780,813694,1140416,2883890,
1560,10092,6962,10586,27640,
9889,114680,90220,66516,271416,
8823,3772,1908,0,5680,
3809,607618,444326,472218,1524162,47318.8176
9789,127588,317920,164958,610466,
3449,98064,211488,34738,344290,
8049,125760,276126,61444,463330,112.7205
2554,15210,10456,7684,33350,
6464,952,758,0,1710,
8514,132952,205328,89478,427758,
5268,2522980,9225382,4244710,15993072,1498335.0452
6810,266978,326102,451888,1044968,
2603,23802,30064,25646,79512,
3230,816204,1225700,457342,2499246,693910.119599998
3231,3234450,5804026,2298330,11336806,1512601.49259999
4012,10622,880,3752,15254,
7932,32,8,10,50,
4187,25146,4714,7040,36900,
5081,327504,414126,602568,1344198,
2240,186382,235754,224392,646528,
2892,45402,52290,60960,158652,
5006,91650,430394,188274,710318,
5886,179764,403478,375660,958902,296078.0903
8429,21840,23814,14428,60082,
5404,1028848,1799166,1622638,4450652,
2190,243110,267710,99480,610300,
2191,107404,112406,51824,271634,
2697,96186,107510,156906,360602,
5096,97574,80282,319392,497248,
5064,1987380,3191462,3353180,8532022,1001461.3327
4715,215032,106410,322908,644350,
1437,510154,886450,1261284,2657888,
1438,314314,360114,371516,1045944,
6074,67650,55252,120906,243808,
5687,268754,200626,498026,967406,55753.6684
4175,560,222,0,782,
8050,380,202,844,1426,
8618,4414,1202,0,5616,
8051,83400,259876,100432,443708,8043.8158
9023,19972,15930,4816,40718,
6812,566616,693490,577778,1837884,344421.7319
6958,207540,382818,510304,1100662,
7289,34556,46988,26658,108202,701.7472
7006,5256,6806,2298,14360,
8807,80004,49196,32874,162074,
3623,364888,330482,341816,1037186,
5702,10990,24420,5250,40660,
2222,51316,72768,30214,154298,
7290,18,104,0,122,
2422,40540,3090,4146,47776,
4182,2740,852,1924,5516,
7501,113022,101506,139160,353688,
3502,22,4440,0,4462,
4317,4630,3042,0,7672,
1865,27970,14042,17620,59632,
7085,11340,16610,34888,62838,
5483,238224,633644,935700,1807568,
8500,358548,199854,180906,739308,
8565,186818,190560,133382,510760,
2945,65754,77630,80396,223780,
1975,4434,6548,3278,14260,
3176,319812,376068,622096,1317976,
6873,47676,68336,133390,249402,
2743,9652,7536,2892,20080,
2550,53886,48130,23762,125778,6.4407
2549,179284,188584,65528,433396,2682.1914
9767,63114,132734,80164,276012,
9107,56416,108414,64612,229442,
2279,69788,116670,55076,241534,
2280,19066,20530,7258,46854,
5927,21078,23930,15084,60092,
6200,5720,3144,2678,11542,
1658,249280,437734,133794,820808,7786.2121
7008,190412,330274,112676,633362,347.6204
9791,41504,69736,54982,166222,
6913,326580,392778,318450,1037808,
1395,532456,619536,320754,1472746,
1179,47868,73894,108068,229830,
5324,23386,37670,53120,114176,
2946,69922,221622,39676,331220,
5689,161216,112428,203462,477106,
4124,1158,762,10,1930,
3811,185004,15758,86374,287136,
2536,14538,1554,1994,18086,
3812,442552,39498,275044,757094,
4412,32520,24388,7728,64636,
992,22450,39566,26672,88688,
3680,66500,11090,26848,104438,
1439,441754,586710,809478,1837942,
3562,1352,28036,5958,35346,
3238,79780,88240,33168,201188,
5682,165758,181740,98852,446350,
3504,25662,189870,46538,262070,
7022,2456748,5527094,3441060,11424902,541285.6711
6962,153696,260538,351468,765702,
9768,209976,335088,261574,806638,58472.9128
1440,1204378,1816256,2237074,5257708,52155.7693
9878,48606,49642,33918,132166,
1659,5527188,9638898,9849682,25015768,757.6204
1129,87856,159592,131396,378844,
1016,76450,125278,31444,233172,
5142,4409954,3645602,14604694,22660250,713964.150899999
1441,781826,1285366,938190,3005382,482018.9631
5164,197983.558032314,602067.139157279,260502.340376057,1060553.03756565,15049.7178
5007,460720.441967686,1401048.86084272,606205.659623943,2467974.96243435,107743.997
7292,7396,8780,7040,23216,
2186,85670,90456,44688,220814,
3542,19894,175098,132,195124,
9112,20778,33502,5820,60100,
3815,568286,102632,571296,1242214,
3899,5316604,3763774,3454506,12534884,1901388.83279999
3900,1610726,162594,1077664,2850984,1078255.775
9624,47196,100324,72602,220122,
9969,29546,62208,53250,145004,
9877,25978,44998,60214,131190,
1964,30124,40012,5654,75790,
2118,330306,1444002,81960,1856268,343473.2092
6201,21088,14850,10640,46578,
9702,125364,165806,136970,428140,
4068,237030,132098,57762,426890,13117.3801
9769,38540,60832,56112,155484,
2640,69980,92948,35342,198270,11242.1538
9028,55500,41306,22472,119278,
9897,76600,164604,110368,351572,
1442,341904,583858,263294,1189056,
8621,3616,1862,330,5808,
5405,378266,384562,533350,1296178,
5406,268022,313790,279390,861202,
9704,24360,55016,16486,95862,989.343699999999
9680,26424,54054,45168,125646,
3098,55412,44460,52070,151942,
5703,30094,189842,24306,244242,75421.5598
8359,198712,305780,94642,599134,8353.0351
2919,59212,53270,57542,170024,
7914,3374,2022,48,5444,
5351,225468,240586,541472,1007526,
5077,265100,279534,608530,1153164,66882.2126
5047,486800,634870,1427898,2549568,35124.1333
3820,504236,101072,349064,954372,
9795,116818,278114,237344,632276,1061.2752
8232,17616,31900,11130,60646,
3568,50,1686,0,1736,
2425,6008,664,146,6818,
6874,1026906,1367804,1489048,3883758,
7447,988340,1185752,549518,2723610,
539,348724,405502,77490,831716,
7469,503780,322742,736396,1562918,
5836,78938,80322,70914,230174,
2762,11890,32802,11532,56224,
5820,8,152,406,566,
6664,156430,82370,104478,343278,
7051,5016,17466,14926,37408,
5097,16988,24404,33296,74688,
5143,5105212,9032928,15421506,29559646,3002833.3886
9911,447350,824836,881454,2153640,
3004,78360,122666,93732,294758,
5144,306092,413582,776254,1495928,945658.723499998
5008,20162,25628,15974,61764,
2947,15966,4922,29542,50430,
9707,19840,38824,46800,105464,
5199,520778,909328,1312694,2742800,77.8991
7792,2092,194,482,2768,
2870,277924,251824,331612,861360,9104.5437
5352,281756,281740,415490,978986,
1372,19654,24282,40112,84048,
2764,15816,16970,5210,37996,
6836,1613544,1870486,5052938,8536968,57405.7738
5098,208422,100836,611280,920538,
4731,664832,1417034,270846,2352712,190905.3998
3774,127878,73260,50686,251824,
2573,18764,14788,6584,40136,
5553,202772,123110,380760,706642,
6814,663058,957502,639852,2260412,345497.3139
5582,154670,162010,235904,552584,
5554,133652,124692,147442,405786,
2412,1340976,2801222,507602,4649800,804391.6414
1130,164032,255600,489800,909432,
6615,457642,1025330,300898,1783870,192436.6865
7736,78716,76732,75524,230972,
5200,19220,31128,71894,122242,
5840,794,1654,150,2598,
5255,560154,1158356,889574,2608084,26037.9736
5009,7454,18316,14548,40318,
5296,9022,8526,9704,27252,
6914,593810,795420,673954,2063184,
2823,42072,29504,48556,120132,1799.815
3267,393834,984640,560218,1938692,40218.2724
5353,46188,45886,61216,153290,
4449,41964,24792,5058,71814,
5099,348504,307362,537866,1193732,
5583,314144,348546,408796,1071486,
3031,47412,126378,107648,281438,
2745,218162,266406,210772,695340,
546,231656,263966,56752,552374,
5879,145554,245708,104526,495788,
5319,24440,56098,72188,152726,
2556,18490,13370,7626,39486,
8233,29162,18312,23706,71180,990.2401
4365,67524,30518,34310,132352,
3785,1008,690,0,1698,
5121,1740108,1202462,3396632,6339202,12008.4205
6850,123184,399624,301462,824270,
5555,62566,55848,104336,222750,
2653,4638,2600,204,7442,
5301,490158,582704,1039144,2112006,
5595,6770332,10006592,13903842,30680766,27330398.2414
6926,403086,627120,775524,1805730,
4069,5900,3196,112,9208,
9792,142008,218338,180890,541236,
4593,1330,1540,252,3122,
5556,154932,151954,386866,693752,
6274,70442,213512,4140,288094,
9718,24342,40420,25088,89850,
2795,306,16,30,352,
3202,424518,82700,256974,764192,
2574,98862,132696,52804,284362,
5048,302068,282746,572426,1157240,3.2614
4070,15178,9034,0,24212,
9855,87826,156268,105312,349406,
9747,22302,27450,14426,64178,
9752,153646,274526,286264,714436,
9762,76504,94922,198876,370302,
5557,193270,194294,241852,629416,
4616,30558,44650,51746,126954,
3828,188154,22600,106258,317012,
6861,591884.310361563,1500023.52341665,2383673.21754429,4475581.0513225,525810.7786
6853,102487.689638437,259736.476583354,412744.782455715,774968.948677506,355.144
9882,173966,23022,90004,286992,
6349,67100,6182,29692,102974,
5457,35406,51330,62676,149412,
2562,44650,36736,14212,95598,
4876,17270,26650,16950,60870,0.9673
2451,116978,138546,22118,277642,4384.9034
3005,1270,108,630,2008,
7515,2314,940,500,3754,
1227,99858,171394,75956,347208,
6488,35404,28552,27768,91724,
8708,3276,2954,32,6262,
6393,9294,4814,1386,15494,
8470,57746,37048,83124,177918,
3624,296358,350036,250826,897220,
2486,22048,19950,6834,48832,
5458,13096,48570,23520,85186,
3019,48684,67056,100596,216336,
5336,6636,4482,25940,37058,
3570,10,202,0,212,
5821,922,12064,536,13522,
7504,17202,31602,5168,53972,
1847,50008,160232,61922,272162,1028.354
9627,71014,115470,98434,284918,
2049,19832,7694,18326,45852,
8824,1248,1270,0,2518,
8825,7294,3798,0,11092,
3905,116984,10538,97272,224794,
1143,75258,173124,231482,479864,
4617,25056,47950,11378,84384,
5896,320244,386452,175122,881818,
8056,46552,101494,89256,237302,
8505,36666,29406,31108,97180,
5408,314494,360276,596646,1271416,
5382,76638,91876,113456,281970,
1030,1844460,3548960,1984164,7377584,446931.5528
7416,33504,46458,6744,86706,
5409,7096,12236,28740,48072,
9185,54000,89770,27296,171066,
4639,152110,292314,343984,788408,
9970,32878,53532,49884,136294,
7579,43710,22686,28148,94544,
9850,24314,50226,15918,90458,
3634,52036,29018,19860,100914,1878.2697
5484,349762,695464,607648,1652874,2990.1597
5100,356652,349526,840532,1546710,
5754,5822,45896,6672,58390,
6837,5196,5624,22356,33176,
2225,111054,159872,220060,490986,
1874,18118,19396,5920,43434,
1243,962874,1674752,447978,3085604,1475640.72600001
5832,22918,121330,18114,162362,
6007,35344,64062,33200,132606,
8826,7880,8792,0,16672,1775.0489
4312,15260,9520,4820,29600,
1519,223480,346606,377554,947640,
9778,31214,115084,83048,229346,
5078,220388,243882,247892,712162,
7295,47414,128744,25142,201300,
1822,14936,25990,6774,47700,
9628,47608,88218,52238,188064,
8473,215010,174958,156568,546536,
8554,173194,198868,172454,544516,
9814,53844,159344,134142,347330,
9902,67866,4278,46460,118604,
9796,144638,348720,195522,688880,
2313,17072,24368,6430,47870,
7406,87732,92238,104702,284672,
5325,49794,72542,212516,334852,
5233,5896,15310,24270,45476,
6524,6286,17798,5080,29164,
5628,85608,110796,105476,301880,
9943,295836,573806,436108,1305750,
5356,840560,1248696,1557434,3646690,441165.104999999
2305,29722,39380,13536,82638,
6008,169028,173080,393252,735360,
3107,21680,11458,36078,69216,
8625,240,122,10,372,
9721,66722,83172,49576,199470,5251.822
9121,67000,101772,29454,198226,
9218,29986,20144,16592,66722,
5201,15016,13434,14062,42512,
3981,18696,2430,1672,22798,
3738,222352,55662,108210,386224,
4147,420,574,0,994,
7440,132284,134260,122660,389204,
2777,58206,83064,157052,298322,
9135,93528,110042,111642,315212,
8711,3218,2350,50,5618,
9790,68832,201064,97826,367722,
9415,122780,181018,228842,532640,
9992,207266,328508,425468,961242,119809.0488
9864,54060,97542,212992,364594,
9483,47946,91954,60552,200452,
2077,8736,7834,5610,22180,
1429,1203628,2672470,2308250,6184348,
1443,1217890,2366280,1712668,5296838,
1957,27262,40736,8692,76690,
8628,1930,1196,62,3188,
7915,3964,2370,0,6334,
3797,62504,5248,39988,107740,
4519,2836,2748,1972,7556,
7877,648384,1362640,258950,2269974,402516.5967
6729,6024,3288,4782,14094,
7211,10542,40250,5088,55880,
5101,880880,1440050,1587228,3908158,817920.7814
8420,57910,62572,80760,201242,
2576,110230,147926,64816,322972,
5668,116884,113462,120746,351092,
2770,76232,76594,143540,296366,
3408,54058,362326,113828,530212,
3409,8612,167520,6234,182366,
5011,78214,247390,190888,516492,
5942,7838,11670,5712,25220,
2963,93320.3495876729,213470.468381929,114146.899052798,420937.717022401,
5412,93126.2219150918,159575.144788631,146210.335246222,398911.701949944,199802.5022
2480,6162,3334,358,9854,
8441,25334,48026,21710,95070,
2306,11752,32118,2400,46270,
8432,75260,60018,61540,196818,
3052,69728,76082,161514,307324,
3060,7198,5496,15222,27916,
5421,1916862,2223698,3046592,7187152,465495.567199999
2103,4562,2686,0,7248,
2855,96,48,0,144,
5145,186336,287714,618088,1092138,
1823,1172684,2204906,585270,3962860,756736.752899999
7212,20260,19566,9188,49014,
3579,6446,11250,23708,41404,
8326,493748,735664,507268,1736680,
3030,643226,1357880,1553098,3554204,512650.910499999
5753,91078,214980,282886,588944,
5502,7586,4454,6092,18132,
3901,33794,3492,20528,57814,
3830,62112,7850,27088,97050,
3861,70816,6842,30432,108090,
8632,54614,21858,4428,80900,421.1799
7897,23660,23348,12102,59110,
2893,37036,45384,78464,160884,
2765,35284,63710,89972,188966,
7348,122102,343936,219288,685326,
3588,604,2676,1448,4728,
6781,20916,16130,9198,46244,
4188,976,552,0,1528,
5036,458,62,4248,4768,
2538,532,330,140,1002,
2452,2294,1624,0,3918,
6417,1265052,1929872,630720,3825644,1436140.96110001
5961,120236.230250648,304632.488159032,34404.0767502161,459272.795159896,681.6905
5962,43195.7697493518,109441.511840968,12359.9232497839,164997.204840104,39.4623
6690,79694,54356,30830,164880,
5357,271147.641017937,464621.276207073,425708.105399153,1161477.02262416,124732.7235
5297,13072.1370669711,22399.5790042965,20523.5593546255,55995.2754258931,744.0847
5413,23120,26160,62150,111430,
4525,135044,304448,273010,712502,
2766,1930,2718,10,4658,
5033,176180,423312,232506,831998,52409.8696
6901,23458,55028,94878,173364,
4436,3046,1028,10,4084,9034.8247
7055,118688,243470,161688,523846,
3099,43208,28868,30296,102372,
6000,264960,230702,296038,791700,
9317,44334,36842,42178,123354,
8057,53416,125304,66996,245716,
1994,5400,2886,2062,10348,
4878,253944,121834,174316,550094,76798.4318
6616,88136,73156,48138,209430,
9994,85270,177596,97318,360184,
9967,13650,30790,36214,80654,
9757,94088,148750,168248,411086,
9993,61470,126946,62788,251204,
1040,66302,38284,140570,245156,
1212,83534,151084,238844,473462,
1691,30248,24904,14718,69870,
8681,742,178,10,930,
9906,32826,96872,36760,166458,
7027,8664,6640,25072,40376,
9866,151514,283674,379562,814750,120660.8516
9868,91182,182102,176188,449472,
9622,35852,100586,33264,169702,
9490,40448,316526,5076,362050,82.7391
5034,5284,7988,7684,20956,
9397,28094,255778,165410,449282,
8713,148548,266292,104530,519370,
5944,7938,13106,8734,29778,
8682,290,58,0,348,
9039,603128,1029402,182812,1815342,63182.723
9186,189714,284276,224750,698740,
9187,73370,88830,74452,236652,
8763,14656,17962,260,32878,
9492,25290,45804,20896,91990,
8642,670,212,0,882,
7744,4916,3764,1938,10618,
5102,26652,41808,160992,229452,
7745,301690,1987404,334582,2623676,8368.4665
5282,108702,211432,221606,541740,
8905,312048,110648,94890,517586,
4455,10724,5076,940,16740,
7916,54736,131352,20760,206848,
3190,1602222,2378166,2392330,6372718,37391.4244
2292,131458,259408,161946,552812,105436.0559
5694,188320,203678,222534,614532,
5584,1579462,1937000,3680482,7196944,
5414,64264,69926,276076,410266,
4520,6138,24892,5134,36164,
5355,5160440,8081240,9364568,22606248,6521664.76299998
2949,99040,78430,102496,279966,
5358,310660,405296,618684,1334640,
5234,9288,9550,14324,33162,
8472,83428,83292,86228,252948,
5486,245498,417300,775084,1437882,
9793,231992,375678,412694,1020364,
5134,14692,24502,58128,97322,
1901,83802,221712,41738,347252,24657.9156
7471,142750,108808,159800,411358,
5283,50790,76452,218242,345484,
5448,322792,1607636,1264376,3194804,6986.9005
3795,100856,9954,63452,174262,
9894,98794,133720,133176,365690,
2128,132236,103894,66930,303060,
5899,432522,604364,637088,1673974,193493.0269
8114,648,386,310,1344,
5566,481046,816744,548748,1846538,55334.5302
9915,34582,5386,17140,57108,
3628,160106,23432,48668,232206,
2950,63652,69136,57730,190518,
7370,366,116,812,1294,
2227,34244,62846,26712,123802,
2824,28620,59864,1026,89510,
5056,201540,182742,230412,614694,
5473,33108.1814017407,62718.4012826386,145517.150710032,241343.733394411,48688.3216
5359,34755.8185982593,65839.5987173614,152758.849289968,253354.266605589,17026.9772
2169,77790,53590,71714,203094,14253.0202
9328,5270712,13345424,3966206,22582342,1496821.3374
6545,25904,12234,20248,58386,2138.8105
9395,368062,234688,267228,869978,
6941,831916,1341220,1486432,3659568,25848.2033
5642,94540,83944,138606,317090,16287.3379
5822,1544,21516,5842,28902,
5669,699772,795952,579480,2075204,
7918,2524,1434,8130,12088,
5246,805354,731352,1459858,2996564,295750.7803
8977,106806,187106,23544,317456,
2121,138086,151584,73010,362680,888.4812
5049,294030,277490,629314,1200834,93.0726
5135,316724,263880,647224,1227828,
7349,25444,24614,21508,71566,
6667,60976,44220,50126,155322,
6832,47620,45070,126852,219542,
1542,900650,1050170,1296966,3247786,
5103,664718,765120,957470,2387308,
6238,110,18,0,128,
7068,436608,862552,910190,2209350,403646.244699999
7473,117602,66084,93992,277678,
5257,67554,115980,85504,269038,4910.6625
375,38726,2070,45626,86422,2.8564
6010,457334,487148,645964,1590446,9572.1641
6815,384924,497352,514252,1396528,
6959,587596,872882,761722,2222200,1283.1572
2747,3448,10968,2246,16662,
5360,1116194,1095974,1847146,4059314,197917.1603
5361,32632,23058,35150,90840,
1041,145806,236596,540448,922850,
5459,20198,23178,74318,117694,
5104,214590,227698,391360,833648,
5558,276530,270254,642012,1188796,
3776,73716,173820,27234,274770,
6004,266380,244178,299960,810518,
5217,34936,82522,140486,257944,
1444,6636656,27898408,9524338,44059402,3517886.7588
2080,32218,35564,9374,77156,
4740,62294,164148,31102,257544,473.4753
5415,185284,168994,206122,560400,
5586,467374,500006,543886,1511266,
5755,325938,1683848,556296,2566082,121497.741
3410,319264,2092954,230680,2642898,1012356.74150001
3414,28458,114892,107820,251170,
9914,312360,1183904,395236,1891500,
5756,107076,694138,159156,960370,
5760,4332,16492,4786,25610,
5065,37292,47598,97594,182484,
4416,28434,11584,2128,42146,
2780,9818,6096,18054,33968,
9452,10840,21950,6346,39136,
3873,37836,2466,36914,77216,
5137,332870,340428,472230,1145528,
9930,183296.230965857,296872.694175644,189806.837319701,669975.762461201,20604.7448
9931,231629.769034143,375155.305824356,239857.162680299,846642.237538799,8681.9647
8726,460,274,0,734,
5337,303158,687742,186082,1176982,
3508,7272,78206,14132,99610,
3591,14948,153196,40074,208218,
5900,505006,671518,468780,1645304,158895.343
5521,867883.711692949,948282.568283249,1224158.96637905,3040325.24635525,11268.0626
5688,187646.288307051,205029.431716751,264677.033620946,657352.753644749,3248.5844
5643,223260,225018,437006,885284,
5545,444842,490654,685918,1621414,865.0984
5105,33046,55088,122342,210476,
2811,13018,13162,12228,38408,
577,3627094,2961062,5457404,12045560,145989.1995
9245,14670,18536,6246,39452,
5167,223518,515136,760412,1499066,43946.8762
5493,1770,958,6300,9028,
2126,182296,524058,402608,1108962,
8637,4250,774,238,5262,
8544,33856,24214,7190,65260,
7214,58042,113164,27728,198934,
5559,1265012,1324920,1724772,4314704,
7490,5610608,3854458,9061166,18526232,1086257.6771
5808,16498,40846,11734,69078,
1377,5080,9620,10274,24974,
3862,19112,2596,2812,24520,
8061,21382,15136,12410,48928,
4074,12878,4724,3970,21572,
4066,1840,712,0,2552,
8062,41418,71852,9506,122776,
3235,524946,182056,357632,1064634,
1445,454716,623488,1055586,2133790,
6119,1733710,2659802,2639214,7032726,1325848.9723
3012,908,124,804,1836,
5261,14814,16798,22310,53922,
5284,26138,42340,23978,92456,
6680,6986,12614,0,19600,
4076,2824,15776,0,18600,
6351,17512,2558,6690,26760,
8583,115156,100232,86734,302122,189.9595
4503,400802,407606,852550,1660958,
5522,417848,540402,929948,1888198,11797.8569
2026,4292,4696,2690,11678,
2513,126060,102444,32590,261094,
1532,232666,501008,784506,1518180,
2935,45386,29454,55602,130442,
2786,62462,66804,92886,222152,
5035,148548,443966,428522,1021036,12626.2023
5027,74556,250054,228082,552692,7101.738
5258,26266,39546,30170,95982,87851.7357
6876,612486,1065172,1529362,3207020,
5362,1273712,2011236,2137706,5422654,
2354,271886,745924,474392,1492202,
8638,42558,70394,10346,123298,
8639,1610,514,0,2124,
9675,33766,65574,41132,140472,
8827,40452,98062,0,138514,355.1505
1042,139716,241520,369110,750346,
2046,11020,10376,3208,24604,
7029,22334,33532,37042,92908,
5218,20854,30768,84206,135828,
5509,509994,849694,236006,1595694,60289.6735
2355,149360,443356,181034,773750,
3344,21114,16666,7688,45468,
5683,91190,62738,61568,215496,
6854,30776,89082,88394,208252,
8556,167986,103176,169802,440964,
2284,108562,39340,30442,178344,
5707,65528,104630,17436,187594,210.1964
5587,136362,117020,170884,424266,
2952,5606,12306,3888,21800,
3144,35894,33610,110630,180134,
6465,772,218,6,996,203.5066
6424,74410,60948,21418,156776,121.6504
9329,108602,206712,30950,346264,
9971,3168,3482,1906,8556,
8474,258420,242598,200292,701310,
2654,19520,7550,786,27856,
9904,103704,181770,179888,465362,
9979,45048,106568,57448,209064,
2104,7448,5072,0,12520,
1559,18474,11020,43176,72670,
2335,59812,166256,97038,323106,
9723,37844,55372,40622,133838,
3961,9722,1014,1300,12036,
4148,472,502,0,974,
8640,2066,1168,434,3668,
2397,38182,28922,30766,97870,
2953,113074,96460,146972,356506,
5416,11252494,6775964,1333200,19361658,1188100.7067
8641,918,584,0,1502,
3051,411102,449780,625528,1486410,60444.6961
6877,864700,821024,1111380,2797104,11793.2502
9794,94168,155218,109284,358670,
2655,8042,3356,10,11408,
8117,18342,24024,17448,59814,323.5587
4022,1942,328,882,3152,
5796,87316,264010,83052,434378,
5169,539866,935122,1256138,2731126,312958.1051
9956,10806,34146,20124,65076,
5363,438072,534456,742892,1715420,
9501,39790,90410,13172,143372,
7921,2268,1392,14638,18298,
2454,2238,1196,132,3566,
9813,6503930,15564346,9991858,32060134,3542124.04399999
9950,2974488,8201434,3506292,14682214,2069874.5952
8360,77420,87914,21164,186498,
2301,11404,11530,24098,47032,
8715,26594,35056,7080,68730,
8828,2970,6152,0,9122,
9503,79230,116984,172868,369082,
9301,27382,39630,9904,76916,
2895,179384,295170,426066,900620,
4760,407644,890876,181018,1479538,68390.1980999998
5338,13982,29154,17862,60998,
4457,116196,82436,22506,221138,
5629,384894,335788,714366,1435048,
2948,24274,29864,28816,82954,
5474,10672,19878,27796,58346,
8284,23722,21724,16342,61788,
9096,102,2,0,104,
8643,4338,1194,186,5718,
5298,12524,24626,21078,58228,
6878,811434,1126836,1906930,3845200,
8025,92180,150100,51560,293840,1408.9644
1220,20202,24822,5868,50892,
6028,418602,417706,477166,1313474,
6391,35062,47488,15668,98218,
3033,64910,198582,158594,422086,
5272,96124,182640,190538,469302,
2962,31026,39466,42830,113322,
1409,692210,938418,725224,2355852,601252.1238
9635,146940,232240,130600,509780,
4131,63260,35846,68078,167184,
6206,8268,3598,1468,13334,
6029,152416,153238,94364,400018,
1965,51922,92096,9568,153586,
3839,139812,14206,52742,206760,9254.2179
6469,190704,819870,359036,1369610,229229.6589
5514,44976,72428,161952,279356,
1132,111282,174788,482778,768848,
5172,522470,1037336,1424614,2984420,114340.8275
7443,1297256,1336558,1350784,3984598,122321.8187
7922,4362,2528,0,6890,
6855,12228,22516,46396,81140,
7032,24076,29604,60466,114146,
6275,6842,2954,558,10354,
4892,169952,185536,204006,559494,28.5702
1463,141996,188598,292394,622988,
7328,70310,295752,33120,399182,136.3988
2218,179492,103362,88872,371726,
1996,3006,2190,1786,6982,
2325,71792,63308,95498,230598,
9725,35300,42906,36578,114784,
2900,83502,130306,156018,369826,
3136,83980,88692,57198,229870,
5138,182114,265552,719262,1166928,
9681,84796,170508,114080,369384,1024.3851
9682,118634,217166,188788,524588,
5146,669188,817442,1331166,2817796,
9610,7448,31484,110,39042,
6276,1796,890,1888,4574,
6280,119486,302382,16182,438050,10517.5658
2825,29576,30976,3890,64442,
8155,6068,3468,3978,13514,
5139,549650,688660,1379092,2617402,659836.5725
2955,105678,91730,140494,337902,7810.9064
5631,2319088,3323374,2549642,8192104,1105291.1011
8567,452448,550844,292952,1296244,
5588,847930,696568,991082,2535580,
3563,2910,41992,9608,54510,
7299,4606,8966,2276,15848,
4300,26090,1832,4416,32338,
7930,18340,11800,2856,32996,
6281,12064,18598,3062,33724,115.1812
5364,212030,201870,405880,819780,
6977,957806,1685958,2185256,4829020,2906018.0532
6867,1129366,1871346,900682,3901394,2405253.7462
6978,496630,995362,648206,2140198,295.8875
3053,179308,250562,419280,849150,
7300,4738,5944,2416,13098,
2896,79646,110422,154374,344442,
6075,124418,129348,137952,391718,
2585,12514,19364,18334,50212,
1022,884466,1407420,931162,3223048,
4577,66898,56774,405832,529504,
9810,168942,232906,239018,640866,
2845,55796,64414,58182,178392,
7266,27204,62084,10898,100186,
2295,18564,64756,35174,118494,
8411,635444,918126,439054,1992624,48486.8735
4521,102158,123996,192756,418910,
2572,51474,37838,67968,157280,
2229,36214,178510,48524,263248,
5173,15970,17528,34602,68100,
7568,21436,44500,5802,71738,
5037,9646,24886,57408,91940,
5947,39258,25824,49900,114982,
9726,185888,427424,234172,847484,6698.2197
9727,231586,379020,310644,921250,
8241,7134,11888,7064,26086,
5450,110762,242538,152674,505974,53048.9402
1413,844900,1342266,1185058,3372224,
5560,339176,305918,403756,1048850,
5561,530332,675388,484416,1690136,
5589,281048,331574,371882,984504,
1033,34314,53446,72876,160636,
1145,59986,80708,157866,298560,
5940,56150,68536,35216,159902,
3007,74722,68218,95640,238580,
2767,123752,84018,81334,289104,
3191,131424,99544,123918,354886,
2557,8054,5746,2544,16344,
4458,32012,10178,71372,113562,
1521,261106,413744,381232,1056082,
7374,1048,334,1640,3022,
1533,65822,131290,133356,330468,
6804,61820,56022,109914,227756,
6827,553842,722536,632364,1908742,
6879,803776,914810,1254854,2973440,
1543,587934,1146820,1621390,3356144,298.2792
5140,15952,20608,38006,74566,
6012,355436,467310,452786,1275532,
7401,102620,135506,170432,408558,
2027,11336,9448,9478,30262,
8213,512314,811492,325500,1649306,1114.4944
1397,973522,1692130,1187222,3852874,226127.0075
598,1004194,1152728,306478,2463400,
2230,95226,159470,26888,281584,
4579,14086,5790,29574,49450,
8009,194208,342858,100992,638058,1378.1028
9246,5146,6542,3224,14912,
6902,23468,44968,22070,90506,
6905,20268,49900,64446,134614,
5633,297862,549770,956732,1804364,105633.8082
5489,162782,386710,739742,1289234,
5219,244212,1036694,749800,2030706,26556.9343
1398,173946,443068,95232,712246,
6070,707868,984460,684998,2377326,
6528,36578,29158,15704,81440,3446.7509
6845,46030,64666,300878,411574,
2826,26984,32878,2784,62646,
2604,22742,25476,30738,78956,
4594,12018,7300,32544,51862,
5532,561390,945684,726702,2233776,300290.0607
6260,100,6,0,106,
4079,72156,61200,140,133496,
2428,23742,2790,3638,30170,
2146,1400,928,2008,4336,
9634,52008,77526,94506,224040,
7569,11428,15434,5940,32802,
5289,97274,77628,169378,344280,
3186,1005422,1290498,1548624,3844544,50376.569
5050,305824,273734,586940,1166498,
3513,6838,62266,10094,79198,
9419,1039320,1133122,607562,2780004,628253.796399999
5490,587246,1346486,2268806,4202538,551463.1557
2768,188728,200604,318094,707426,2422.5309
5220,80510,207184,321426,609120,
8498,211946,125222,99866,437034,11.2894
1434,122722,248264,105520,476506,
2860,143538,151202,212578,507318,4761.9235
6283,6186,3598,38,9822,
3845,248134,22582,158982,429698,
3908,41086,3274,17176,61536,
2861,228194,265218,343816,837228,
8524,248330,377178,148970,774478,37338.0583
6220,33882,16074,14668,64624,
5893,132406,163352,216094,511852,
1148,48690,84380,45930,179000,
7887,9430,3068,6460,18958,
9981,176711.785659214,381599.994988435,207010.619892059,765322.400539707,167.9374
9982,3296.21434078643,7118.00501156515,3861.3801079414,14275.599460293,
2656,17840,8658,418,26916,3211.5856
8647,3378,2298,92,5768,
2149,41466,25766,17754,84986,6193.7935
1391,580798,789084,620194,1990076,31909.345
1522,241530,300850,584780,1127160,
4028,71208,5512,67138,143858,
4524,34608,37660,61102,133370,
3146,160898,350684,284408,795990,
8129,632,12,0,644,
3607,290146,525876,412262,1228284,53913.2417
5174,96230,252748,606826,955804,
5066,729806,900872,1242314,2872992,1654798.7891
5590,209860,161194,477438,848492,
6818,218559.878761637,267494.609222775,449416.312333117,935470.800317529,
6085,377618.121238363,462165.390777225,776481.687666883,1616265.19968247,5554.908
8067,21802,13828,12784,48414,
2138,26244,18868,8958,54070,
5417,5376,20136,10288,35800,
7766,10776,5984,4024,20784,
7506,123480,168486,52298,344264,2743.8754
3194,9252,14508,14850,38610,
2691,3616,6542,0,10158,
5235,224028,376780,625976,1226784,
9909,210254,364536,282796,857586,
3054,794338,993806,1121460,2909604,88502.1895999999
5202,31064,44268,118894,194226,
6919,664822,772840,920552,2358214,
3314,61296,118502,20398,200196,
6009,6901838,12071020,10879844,29852702,3837080.2749
2356,74582,167494,66796,308872,
5236,86576,123326,392082,601984,
9983,83070,139154,95308,317532,
9676,45104,95182,112910,253196,
9630,82722,98178,148158,329058,
2231,114482,251812,169080,535374,
5539,130234,72738,102154,305126,5778.0218
5591,79284,76438,231516,387238,
1870,92978,141380,94480,328838,
2398,90892,137748,117784,346424,20792.9074
5880,54058,63634,53170,170862,
6086,798410,1049282,1365724,3213416,169471.5286
5107,733970,910054,1727576,3371600,1118876.4636
6880,170726,221650,567740,960116,
5141,9514,17634,30444,57592,
1221,75390,84786,39572,199748,
5308,11210,15540,27846,54596,
5941,14506,5938,6516,26960,
2437,62006,140862,8380,211248,490.0679
9738,32380,48254,56700,137334,2.6215
6979,1207604,1930600,1677372,4815576,
4794,15640,34930,8926,59496,
5717,64068,236654,89328,390050,4821.20640000001
8436,21198,17438,19202,57838,
5418,815350,1215800,1040128,3071278,
5523,176998,229664,358776,765438,
2193,403926,201938,173546,779410,109870.0422
2432,19646,1734,3016,24396,
2828,24620,34612,3642,62874,
4189,650,202,480,1332,
5365,267154,340408,316212,923774,
8212,144494,95062,134114,373670,
6015,453066,535988,686038,1675092,
8499,431806,327746,384704,1144256,1211.1042
5309,470282,857806,1202346,2530434,139438.7943
5562,121148,123284,204276,448708,
2105,10096,6016,0,16112,
8720,165706,178640,294846,639192,
2399,478,546,0,1024,
2303,80098,125960,80338,286396,
5563,334082,343750,500064,1177896,2241.0472
5273,362472,867786,812948,2043206,399754.9633
7327,34202,71806,19274,125282,
1563,11174,8214,9606,28994,
8071,33712,49014,39860,122586,
1734,21204,29614,60744,111562,
1023,743016,1325522,927804,2996342,
2194,156994,235078,87488,479560,
6221,322,46,814,1182,
1862,83692,31766,37784,153242,
8437,1413458,2139042,1540042,5092542,449945.1335
8126,431644,1601296,350304,2383244,72951.559
2937,10856,7944,16814,35614,
2558,10140,4804,10064,25008,
3072,63856,151194,169248,384298,
8098,9608,12148,2036,23792,
6108,390358,765508,685070,1840936,38.5811
8921,43982,32094,18828,94904,
2235,253236,776776,420256,1450268,73238.4086
5463,86722,127814,420220,634756,102539.197
8099,7972,20342,11658,39972,
2160,214638,479936,313788,1008362,20406.7468
2829,33406,30866,33150,97422,
2959,16254,8148,24242,48644,
6310,61134,20148,26332,107614,
9845,371614,841004,554494,1767112,719688.5447
6851,40588,70660,93538,204786,
9618,1170,962,3900,6032,
5495,51158,74602,162644,288404,
6881,1697882,2884350,3539522,8121754,27672.8829
8568,414782,564958,377962,1357702,
9586,870400,1000456,1262146,3133002,
2236,9114,11242,4180,24536,
2122,992,96,0,1088,
6882,161254,136066,539098,836418,
8922,51278,23238,23624,98140,
8648,21828,3484,2574,27886,
8778,2720,726,862,4308,
9136,349780,656468,265980,1272228,258798.8069
9646,23034,40106,33872,97012,
8649,457752,762516,39228,1259496,61947.788
8614,574,96,156,826,
8924,194518,170952,146238,511708,
7217,692604,1481352,1168410,3342366,570049.2425
2817,120920,99086,142352,362358,
9508,215932,492144,289836,997912,
5592,361298,338782,746150,1446230,
3110,4366,9928,5306,19600,
3170,52668,50528,126786,229982,
3555,6274,39916,9328,55518,
9507,17264,10544,3594,31402,
1097,98238,113440,209428,421106,
4081,5514,2850,0,8364,
9648,288776,557396,468726,1314898,
9995,59246,159968,66580,285794,
2605,12354,9704,12850,34908,
5038,11764,17974,6436,36174,
8468,680388,612044,412590,1705022,1390.4183
8925,35752,46936,9304,91992,
6838,85846,141582,638278,865706,
1655,10130,29322,26486,65938,
3325,56346,228554,82290,367190,
1384,3544,3474,4788,11806,
5678,15206,39610,5624,60440,
5079,6084,5280,14076,25440,
5205,50480,29242,68466,148188,
1976,48228,103946,51852,204026,
5419,105484,106210,205866,417560,
7011,10932,5998,20220,37150,
9816,10434,40340,28466,79240,
1447,150458,298198,234072,682728,
1448,638546,891088,1170498,2700132,
3092,1106210,1516430,1494968,4117608,2034.1463
5080,311058,327134,439176,1077368,
1553,791424,933308,1007362,2732094,
1449,526182,691032,808558,2025772,
1399,247034,484748,406942,1138724,
1966,8870,16324,3068,28262,
1857,180198,447122,434286,1061606,84576.3373
5593,333936,314408,541554,1189898,
5594,363798,643408,294764,1301970,
3571,1836,4660,2626,9122,
3237,194018,155812,122800,472630,
5108,354994,343126,875320,1573440,
4581,288794,497908,826938,1613640,
1229,95678,97030,35688,228396,14980.8013
4132,14474,6372,9146,29992,
1415,165484,433884,329822,929190,
7516,1004,412,0,1416,
8652,54,22,0,76,
4083,12394,3800,0,16194,
9512,167542,310604,110472,588618,17322.9609
9516,22716,45922,35510,104148,
9960,21672,49372,57874,128918,
9517,238084,441724,337318,1017126,135125.2128
8653,372,92,0,464,
3008,43610,105614,35036,184260,
9142,28410,49808,20072,98290,
6121,5599578,20153446,8063372,33816396,3472998.25200002
1392,219934,209940,318968,748842,
7115,215762,615650,166904,998316,578.5937
1109,232590,314360,742938,1289888,
5823,300,3172,4558,8030,
9817,33268,101288,81758,216314,
4508,21408,24726,21250,67384,
9217,7832,8052,2916,18800,
5565,1531152,2279822,1629190,5440164,
5366,79564,67378,119674,266616,
8655,23494,18790,1916,44200,
3073,12094,52160,35230,99484,
6862,6670,12734,26928,46332,
6527,53192,31220,40134,124546,
2124,308938,1488186,631216,2428340,66613.957
1867,73810,66192,38806,178808,
2057,10580,8682,700,19962,
1959,6142,3954,4482,14578,
9145,299690,575646,242358,1117694,25760.5186
9518,4578,13244,1228,19050,
2245,263510,350038,279650,893198,60419.1037
2668,110490,104732,60270,275492,48869.8650000001
9771,20342,42448,10064,72854,
9230,18294,18420,10876,47590,
6544,42518,30514,21504,94536,
9766,36352,72994,57302,166648,
6466,244,114,0,358,
6401,25636,15838,18376,59850,
6565,22052,13074,17258,52384,
8214,140006,167530,75582,383118,
6088,170966,156028,266678,593672,
4206,11716,8998,0,20714,
5109,70926,52214,149592,272732,
8546,83860,70724,16892,171476,
4228,2342,1036,292,3670,
2848,147464,172706,193252,513422,
8657,23494,39138,72,62704,
9149,35014,38210,8994,82218,4718.4272
5057,306026,367322,618114,1291462,
7445,745564,437300,1019168,2202032,
8658,3738,1838,0,5576,
5504,37652,5296,10838,53786,
7201,168,328,22,518,
4084,4056,1500,0,5556,
9710,97112,150298,80624,328034,
2685,606988,1240346,299462,2146796,395921.3648
5275,164064,341592,245716,751372,
1017,42440,50872,15024,108336,
9652,16078,30864,13710,60652,
2735,17732,18904,7360,43996,
3171,198622,231458,387506,817586,
4607,46174,47252,95216,188642,
1761,70128,30296,21018,121442,
9818,55362,125340,87980,268682,
2058,2398,1672,62,4132,
1871,9460,9554,3138,22152,
5824,156,1466,640,2262,
4595,12778,8236,25210,46224,
9876,239796,330064,233952,803812,
9521,100944,280232,60644,441820,
9728,91670,200644,142180,434494,
8931,34574,34080,27348,96002,
3225,93348,31234,45502,170084,
2669,35936,20928,28460,85324,
2059,1620,974,1556,4150,
6927,73986,92010,148990,314986,
2339,105034,200338,140588,445960,
1133,98524,139492,332788,570804,
1534,272868,790618,798426,1861912,
7925,2292,816,14250,17358,
4597,830938,1078728,644202,2553868,204260.5898
2237,210604,180958,149684,541246,
5368,606686,506482,913348,2026516,54269.6655
4784,52020,98612,59466,210098,0.5395
5110,369508,418382,916134,1704024,
8487,8823526,15037190,7081876,30942592,3130908.6708
1947,1208434,3133628,1080866,5422928,494187.1828
5294,6750,11378,26230,44358,
7446,730248,565306,1045474,2341028,
1373,273400,595964,971554,1840918,
3539,428,7894,0,8322,
3498,5178,116080,0,121258,
5111,21942,32040,40974,94956,
9955,153264,345328,183648,682240,
3620,95670,75552,89064,260286,0.174
6089,511700,683168,695248,1890116,
9188,151310,378922,26370,556602,
2862,179774,231242,181622,592638,
5329,397738,1036536,808096,2242370,415312.9934
5051,2052556,2738870,5957492,10748918,3756220.83810001
2710,164524,162656,89624,416804,
7402,66864,88786,130970,286620,
7403,51524,69272,89700,210496,
1177,228800,269310,214262,712372,
1291,129006,400370,571208,1100584,105471.0062
1579,2042,10232,15052,27326,
7491,1165412,689450,1584356,3439218,
6340,650982,943880,221156,1816018,27617.8791
5369,80930,140018,352270,573218,
7305,16224,20560,12424,49208,
9438,319718,558788,278098,1156604,
5634,104660,148332,274110,527102,
3573,22028,239430,96866,358324,66423.7303
5635,57032,90718,92348,240098,
3853,118440,12398,79332,210170,
3066,2010,1608,1668,5286,
2156,68116,51818,15552,135486,
2661,69850,155280,185948,411078,
5260,116316,393546,344524,854386,2694.5489
5498,63186,75398,130416,269000,
7072,48700,74502,119612,242814,
2242,3614892.88,8743072.68,3677065.44,16035031,424769.7061
2244,761030.08,1840646.88,774119.04,3375796,
2246,3519764.12,8512991.82,3580300.56,15613056.5,1103789.5415
9709,392956,1025166,565604,1983726,729311.2173
6965,15835902,18082722,33420594,67339218,2745129.3428
9371,366982,493480,340526,1200988,
9372,104990,127710,90990,323690,
4327,1676,628,0,2304,
4356,7988,3134,444,11566,
4226,436,424,0,860,
4018,42504,2692,46022,91218,
3844,270560,29858,168618,469036,
4460,2884,1388,0,4272,
4334,1134,276,382,1792,
4248,10460,8252,52,18764,
4059,8814,6782,0,15596,
4227,16996,23632,140,40768,
2484,129734,150870,16158,296762,
2485,128770,168302,22968,320040,72643.3423
4247,5288,3794,300,9382,
4133,195026,100974,117062,413062,5094.5723
2488,5858,6216,1184,13258,
2467,8198,8120,3202,19520,
4060,3304,2020,0,5324,
4162,1096,900,0,1996,
4138,2148,916,0,3064,
4207,408,312,0,720,
9925,62028,39562,72036,173626,
9916,61382,6678,19676,87736,
3847,152206,13120,101922,267248,
2457,8628,5882,260,14770,
4223,18808,6056,9118,33982,
9699,149720,78378,69860,297958,
4061,1316,890,0,2206,
4163,3990,3494,0,7484,
4421,14486,6514,9076,30076,
3852,38962,4904,17482,61348,
8712,2708,1360,72,4140,
8846,320,252,0,572,
8829,1140,556,0,1696,
8830,168,204,0,372,
9156,20714,34282,8822,63818,
8660,424,108,0,532,
9655,36920,56648,96518,190086,
9614,38408,204094,8438,250940,
8443,16984,17342,14058,48384,
5148,9742640,13477512,24654098,47874250,1986739.82300001
6966,345486,528698,456814,1330998,
5281,94644,201360,86598,382602,
5632,161144,115826,291808,568778,
1067,58570,143106,143268,344944,
1829,364316,122320,148798,635434,5798.0114
2657,8754,3974,342,13070,4.6438
7978,18138,19022,7858,45018,
1110,256574,311182,395566,963322,
5674,11456,468,3066,14990,
5114,101862,192980,334638,629480,
9354,71684,70934,46960,189578,
1305,25560,12732,9980,48272,
1306,38438,18778,15838,73054,
3574,3490,108644,10926,123060,
2598,66982,47216,162316,276514,
2307,20352,19242,15642,55236,
2689,16762,13106,9920,39788,
3517,6638,44576,21316,72530,
1897,316650,752296,249050,1317996,40917.3185
5082,221918,262034,370874,854826,
6202,35512,7824,13900,57236,
5053,158778,175536,250796,585110,
7268,106274,282174,61416,449864,6208.6971
3635,118116,100146,81540,299802,3184.6037
1536,607824,1901020,1173950,3682794,133921.6898
3645,1988648,1329824,501340,3819812,126468.3054
3518,58,2346,0,2404,
4826,105090,49394,34356,188840,
4640,17588,29678,42322,89588,
5892,26998,74882,26698,128578,
5887,73608,140922,50356,264886,
5762,5198,58070,1422,64690,
5761,14264,84212,17050,115526,
2670,42336,48070,7828,98234,
2871,354972,1057512,248914,1661398,7218.4532
4422,72998,62022,970,135990,12777.9889
3963,125552,17404,47762,190718,
3962,2214,392,484,3090,
2155,285424,1022636,557288,1865348,
5853,9328,10708,678,20714,
3147,977978,1578534,2052600,4609112,486431.4205
5237,55514.9319471741,99294.8720680345,116900.2060871,271710.010102309,55209.3303
5115,278627.207942251,498356.964458241,586717.426960307,1363701.5993608,28222.775
5222,172971.860110574,309380.163473725,364234.366952593,846586.390536892,74067.3478
5599,126126,117632,218270,462028,
8831,17392,69014,0,86406,
8164,101878,167626,84416,353920,
4884,124034,116128,114252,354414,21216.3744
2961,1260036,2634198,347058,4241292,15283.0604
2966,1902963.52793875,4353032.51024763,2327652.93619812,8583648.97438451,815948.141300001
2968,6164723.92114537,14101817.1139172,7540521.67854614,27807062.7136088,2711674.7974
2970,1823764.2013282,4171863.90745319,2230778.48620294,8226406.59498433,700395.9181
7165,6306,3962,3184,13452,
6856,193146,365920,509576,1068642,323425.8482
6883,442590,761532,1169666,2373788,
2253,92516,106004,52720,251240,
4094,6706,2722,0,9428,
7603,4924,2150,2330,9404,
1727,160514,191912,46934,399360,
1728,71288,63536,44778,179602,
7166,109802,159438,126710,395950,14.8026
5223,59590,132232,334998,526820,
5018,113358,557062,222504,892924,6683.1185
1909,164680,418046,305310,888036,
6318,19650,38016,8732,66398,
9160,95160,175932,38528,309620,
6863,78420,101318,377718,557456,358275.5788
3021,67186,99612,109390,276188,
2830,136660,124112,209386,470158,
8445,58900,61040,59972,179912,
7928,26948,29140,18166,74254,
1034,133574,237852,377012,748438,
5040,5880,16974,21800,44654,
5692,172384,200062,213784,586230,
7947,6298,4762,2636,13696,
9957,14078,36254,13718,64050,
6970,254738,460142,535206,1250086,
1475,3171458,7745314,5750164,16666936,637393.607399999
1988,32748,39678,17136,89562,
1581,56548,142852,22270,221670,
1582,12378,60606,2624,75608,
2867,123596,168872,106414,398882,
9802,35458,91200,51572,178230,
9529,30850,63268,10480,104598,
5149,226474,242562,364606,833642,
6663,665934,896704,452534,2015172,39842.9026
7036,70150,72602,127182,269934,
3346,30008,29522,15136,74666,
7221,16934,36372,15034,68340,
1851,90542,128572,45602,264716,
3576,968,840,4050,5858,
8574,225386,267872,174008,667266,
2254,151952,169188,63308,384448,
2357,32822,20764,25760,79346,
5116,57582,102938,162042,322562,
9705,23418,52464,47184,123066,
5475,116038,156244,366354,638636,
3855,311442,44284,194490,550216,
3857,31508,4964,15598,52070,
6297,56452,11752,31500,99704,
7725,156992,183124,10260,350376,
6707,82560,73742,53626,209928,
5908,27144,38356,108568,174068,
8477,58170,68084,44892,171146,4897.8483
7929,487738,681456,187088,1356282,80908.3543
2971,3726,10020,11078,24824,
3159,9180,19064,8166,36410,
5644,74206,60858,155728,290792,
4095,38566,25404,122,64092,
2750,33956,27048,12466,73470,
1527,543546,576098,764152,1883796,
1537,2110,4956,6588,13654,
5909,13886,7768,18516,40170,
9658,48102,79546,113750,241398,
1997,82210,57704,54852,194766,
2920,99494,122380,108754,330628,
9985,244398,437238,284650,966286,
1378,1220966,3398572,2231786,6851324,458214.6056
4469,6412,2834,6272,15518,
5019,16640,26982,23174,66796,2517.1069
8518,159544,210244,136198,505986,71465.9863
6906,8742,20954,47910,77606,
5069,276128,322866,780514,1379508,
5427,124848,136734,221630,483212,3447.1001
2849,6750,8300,3652,18702,
9060,3054,690,2086,5830,
3067,5698,5574,8680,19952,
3203,56182,28238,27120,111540,
9080,133744,155464,64982,354190,
2226,1617188.92,3911374.62,1645002.96,7173566.5,534248.1616
6005,2472728,2621448,5739802,10833978,778076.941
2799,15566,12112,19984,47662,
8539,85320,81190,93388,259898,
8833,1704,2872,0,4576,
5825,1020,9208,2982,13210,
5291,22488,22366,27406,72260,
2695,110162,96814,31000,237976,
5957,15286,40964,3292,59542,
2151,163072,175340,150022,488434,
4814,57606,169936,32564,260106,
4470,7036,2932,912,10880,
8504,145976,97904,125046,368926,
7680,140920,178980,62380,382280,582.3812
5501,36274,80688,76786,193748,
5600,541420,580394,726280,1848094,
2606,7968,6698,7216,21882,
2675,1448,976,404,2828,
2903,82708,83946,155460,322114,
2171,85580,111604,79070,276254,
9632,29066,91110,66552,186728,
2973,19730,28380,20064,68174,
9691,437450,555448,394458,1387356,193390.7463
5645,286290,335434,531384,1153108,15266.3527
5118,325088,346430,644174,1315692,
2158,12552,17834,3360,33746,
5312,86906,161992,83210,332108,
9819,260968,680244,389696,1330908,6061.4238
3859,69592,8822,15250,93664,
9779,18826,26684,21318,66828,
8665,39608,21556,3316,64480,
9608,99088,148406,143216,390710,
9304,227432,128732,107526,463690,
8526,71176,68380,26450,166006,
8107,8424,16960,9858,35242,
3389,194168,169722,140158,504048,
8666,36574,72820,11110,120504,
1247,108022,57992,50278,216292,
4098,14222,5270,432,19924,
1881,94232,63146,240296,397674,
2940,39804,30858,35546,106208,
4216,412316,246132,160136,818584,
7354,35758,30266,25682,91706,
9773,59034,110600,227068,396702,
2565,57948,47026,27996,132970,
2139,36102,6070,2720,44892,
6241,3448,1314,2980,7742,
2047,222,190,0,412,
5911,31156,36972,37612,105740,
6018,407070,395586,463992,1266648,
5058,229488,223662,335346,788496,461.6331
2152,294128,335012,234902,864042,
6289,568,466,252,1286,
5150,725372,1141386,1443970,3310728,671299.059700002
5345,1285212,2764014,2564938,6614164,1046782.2759
9533,9166,13400,4038,26604,
5119,578688,543534,1109472,2231694,
6209,9074,4224,1698,14996,
5238,39108,38464,47040,124612,
2358,1046,5208,606,6860,
5567,795820,1029402,1156184,2981406,30396.8459
2974,41208,59366,108594,209168,1522.0457
2769,35028,45536,123984,204548,
5881,168306,307572,152076,627954,
8506,327092,268572,306198,901862,
6019,277318,220374,339052,836744,
6498,214625.701530192,418021.136620414,119747.335271212,752394.173421818,54872.8064
6499,256966.298469807,500486.863379586,143370.664728788,900823.826578182,235898.4165
9919,87106,8756,40004,135866,
3074,374804,784730,689512,1849046,51138.1093999999
3071,17582,59958,22762,100302,
7728,1748638,5885726,792280,8426644,409466.886899999
9589,16898,68846,13650,99394,
8808,99176,99734,35860,234770,
5330,10296,14590,27456,52342,
5331,55860,101468,79088,236416,
5175,27488,28840,77952,134280,
7038,94556,128192,141036,363784,
7039,33062,44014,99066,176142,
3674,915582,951118,747450,2614150,557388.338699998
3523,1546,101424,20,102990,
1863,20168,9060,6640,35868,
9774,125044,243214,285054,653312,64825.2766
3426,150718,825250,217486,1193454,348334.191299999
7834,28336,26356,7252,61944,
2789,45154,54286,80996,180436,
5828,646,1804,490,2940,
6929,49586,63018,29040,141644,
2257,212570,264660,320028,797258,115072.0136
8668,4934,3632,204,8770,
9571,28416,42596,17886,88898,
4426,101934,47404,12384,161722,
3895,69802,5806,50014,125622,
9609,27504,46522,38100,112126,
5568,699390,797834,837346,2334570,
5428,577046,928138,1978198,3483382,
5460,1798,5324,1038,8160,
8528,97132,123168,38938,259238,
9358,152992,297372,115998,566362,
5636,112560,172642,109768,394970,
5429,198120,203094,221770,622984,
6875,15852,11698,68880,96430,
2455,672,910,0,1582,
9189,39800,83006,33666,156472,
7895,13330,10752,9268,33350,
5601,139070,138284,234196,511550,
7308,61384,123442,66556,251382,
1422,229104,428244,326984,984332,
7996,123728,477336,104812,705876,
1069,495816,1660028,991166,3147010,3544.5957
1111,170198,244226,448772,863196,
5120,31878,29416,50056,111350,
1478,76562,77442,105376,259380,
6971,81014,125790,230606,437410,
2326,89904,117534,45200,252638,
7309,748420,2785258,577660,4111338,454122.366000001
5376,940078,1462854,1959620,4362552,1182762.6986
1826,1905592,4447456,1115816,7468864,440094.169899999
1077,446918,533736,305366,1286020,599545.210499998
5068,316436,344024,496256,1156716,
7946,19646,14272,1896,35814,
5262,12734,17358,31786,61878,
5476,16744,20884,40668,78296,
4689,13770,29118,16118,59006,
1904,61590,119644,39884,221118,4719.6934
6020,336246,266466,439036,1041748,
8725,60054,102214,2064,164332,
7451,421692,376698,192048,990438,
5310,10242,7872,14566,32680,
5786,0,5926,0,5926,
4641,50850,58082,84970,193902,
2258,177514,505200,238592,921306,
6003,2116612,2711726,495208,5323546,
3219,129784,73466,109986,313236,
4533,132210,160926,187312,480448,
5021,21928,29278,93204,144410,
2281,406564,1152890,703750,2263204,53057.0239
5122,1178930,1813676,2162410,5155016,1153873.6107
2259,30566,37866,22486,90918,
2247,297446,349236,410734,1057416,
5071,83408,163904,160814,408126,49395.2827
7273,30980,66126,20814,117920,
7274,14424,28498,5694,48616,
8309,174758,120296,112112,407166,
2157,79712,60244,15010,154966,
5526,33098,46298,114584,193980,
2090,80422,474284,16474,571180,292288.4108
3115,1101860,4086938,1442700,6631498,307268.4629
3121,111642,521172,176998,809812,
5602,137936,135800,235354,509090,
5377,211554,403896,917886,1533336,
3087,6575570,17797990,11462410,35835970,2976075.7784
5224,208426,347510,618796,1174732,80442.9659
2387,66276,40662,43790,150728,
3427,53964,542790,81150,677904,
9657,69202,131342,197604,398148,
9683,936310,1484404,1694558,4115272,119548.1606
9664,18548,32736,30294,81578,
6021,592384,613212,707032,1912628,
3036,96048,166412,193948,456408,
8479,69534,49398,43094,162026,
4250,2098,1978,0,4076,
3524,15264,132652,47816,195732,79969.7664
2402,33312,61726,38444,133482,
1561,7188,4524,8490,20202,
5882,74076,114018,59048,247142,
3246,54624,52400,38584,145608,
9917,529774,1463234,1032998,3026006,481579.834399999
2032,3656,2612,1128,7396,
3213,48180,10350,29478,88008,
2916,23152,20740,29704,73596,
9775,101382,130566,236588,468536,
1687,3440,270,422,4132,
5423,1661136,2649528,3153536,7464200,2391595.7729
7685,658,64,392,1114,
2403,18394,25242,21046,64682,
4140,69536,25326,50564,145426,
4101,21574,8250,20,29844,
4102,37684,11082,596,49362,
4129,3834,1498,0,5332,
3863,350842,53598,228972,633412,
3851,106090,51902,75428,233420,
4021,237756,15576,237010,490342,
5072,421120,573912,776280,1771312,2254.5647
5378,171978,289932,235036,696946,
4335,7480,2910,10,10400,
6634,67252,57872,31128,156252,
1195,104404,48842,83604,236850,
2494,6278,4818,1116,12212,
3499,22604,122488,56522,201614,
3992,32100,4266,7634,44000,
4473,12682,4624,39482,56788,
2102,69380,431594,46234,547208,75344.8466
3525,27222,173482,55096,255800,
4463,2072,854,308,3234,
5477,6516,10844,14534,31894,
3944,17002,2502,2946,22450,
4254,936,922,0,1858,
4409,2042,1498,0,3540,
2433,18258,1476,2652,22386,
3526,29432,475684,55222,560338,17.2962
3528,4120,21014,9518,34652,
1128,68774,142168,417920,628862,
4887,27532,56746,19678,103956,
8805,282446,699708,99322,1081476,121350.8691
6133,825812,2826368,1122564,4774744,927701.479999999
5657,282314,490142,660522,1432978,10913.8831
5123,564650,547128,1161706,2273484,
5461,23760,41376,59110,124246,
5462,406,590,6250,7246,
3062,44536,114544,79824,238904,
3214,190,40,0,230,
5757,26290,42406,25546,94242,
8801,20660,98800,1882,121342,
7452,439034,351328,441034,1231396,232679.9366
2752,4162,5296,112,9570,
8670,6134,3864,0,9998,
5225,15884,33398,62038,111320,
2308,9614,13118,4950,27682,
5332,17374,44826,46722,108922,
5208,294544,392428,644856,1331828,
3580,239290,2009288,260874,2509452,100530.902
5885,113220,141836,68142,323198,
5455,88454,451100,311168,850722,
1078,168,12,1090,1270,
9820,76012,166572,141316,383900,
9804,32574,79444,34410,146428,
9821,84368,241566,99558,425492,
9623,44298,113774,40274,198346,
9936,194462,320076,241674,756212,
3422,16866,98154,14816,129836,
6819,147300,205196,210818,563314,
4251,3110,2380,32,5522,
8540,2288,3020,840,6148,4.8126
8548,100466,121962,49254,271682,3138.2054
8541,22400,10714,214,33328,
4023,13956,2148,5660,21764,
3850,114308,75540,113048,302896,
2459,526,286,0,812,
3744,40306,7986,23540,71832,
3904,461762,48938,291150,801850,70803.3235
5883,329298,660442,183616,1173356,6922.7274
8254,20910,23840,16706,61456,
9667,109150,220830,222518,552498,5047.2588
2198,242658,256568,160628,659854,
4181,217830,167964,118730,504524,
5928,126436,138172,93916,358524,
3870,175138,16608,149996,341742,
4313,40644,23236,8240,72120,
8860,24534,8440,12962,45936,
5276,178822,321144,450842,950808,
5537,407473.312685828,1103235.98860258,501573.448959366,2012282.75024777,23950.7139
5829,218,300,0,518,
5540,416868.687314172,1128674.01139742,513138.551040634,2058681.24975223,145418.7498
9958,13054,36494,23590,73138,
6022,498026,652610,833690,1984326,
2671,189656,278654,81982,550292,
2874,87692,104962,44092,236746,
1346,2600,2246,1992,6838,
2337,88856,155944,173428,418228,
2521,176244,126438,44050,346732,
2875,22952,28324,13182,64458,
2753,1454636,2753334,677046,4885016,1493798.8111
5285,126644,189760,210712,527116,
9366,96174,68320,93024,257518,
9543,97990,247224,75574,420788,
9544,78116,22962,16792,117870,
9808,40240,56722,47804,144766,
3055,144170,163022,276426,583618,31597.6558
7419,61506,66604,81598,209708,
7509,51120,66934,37282,155336,
5468,70906,131556,128582,331044,
7453,303492,276494,127404,707390,
5379,681930,1064136,1283210,3029276,570077.4339
5430,167024,160930,281404,609358,
5603,1884474,2420684,4562660,8867818,
4314,27052,34388,18062,79502,
1663,52886,1878,26578,81342,
4185,40754,27346,50810,118910,
3994,45068,6980,17852,69900,
5176,55470,53620,44076,153166,
9822,130246,424284,143410,697940,
1419,784186,1396784,750132,2931102,
5424,632396,970916,1221072,2824384,
5596,450624,438100,936672,1825396,
3531,34,2308,0,2342,
6242,4222,1590,662,6474,
1546,277696,385608,540146,1203450,
3118,32882,52696,59770,145348,
3874,262012,27290,212394,501696,48222.7138
2404,11206,30350,4718,46274,
7454,584482,602620,585078,1772180,
5177,265924,499514,1055934,1821372,
2296,91464,189026,96966,377456,
5023,161228,577604,524990,1263822,77517.1597
2734,36728,45988,30826,113542,
8834,5080,2700,0,7780,
6361,2772,342,7834,10948,
1999,20928,11236,474,32638,
5083,73222,58858,64328,196408,
8519,15766,16640,10142,42548,
8031,424,46,218,688,
6884,312992,426416,1080424,1819832,
5569,1058742,1344434,2028868,4432044,174616.656
3149,3535904,7636376,5949720,17122000,4108907.70260003
3160,118502,146566,169544,434612,11855.4478
6967,272586,355860,354488,982934,
5912,16738,9208,17202,43148,1743.7446
7950,151660,144374,51536,347570,
7974,45414,39164,30284,114862,
2979,56058,66956,73892,196906,
2857,70,24,0,94,
1208,318782,409486,304672,1032940,
5478,758404,1253226,1693652,3705282,856170.568299998
3247,46990,29628,17836,94454,
3530,31622,245172,63562,340356,
5431,53258,46490,122362,222110,
7316,12074,19024,19204,50302,549.3381
5480,270370,337886,585300,1193556,
9867,20980,41638,55548,118166,
6511,127226,303442,76232,506900,115756.3954
3906,54282,4822,31088,90192,
3876,83348,40130,57794,181272,
2544,7510,3632,1848,12990,
2461,251696,216910,65854,534460,
4027,110410,10702,70056,191168,
2106,11582,6152,0,17734,
2131,84340,119302,121680,325322,
5570,3105232,4371678,4173634,11650544,1602560.0255
687,450128,533318,178750,1162196,
5432,81238,90992,166062,338292,
1538,6278,11956,16154,34388,
7510,11384,11576,5416,28376,
9920,65286,5316,40742,111344,
2580,23420,21412,7394,52226,
5226,34744,88134,186350,309228,
2261,66496,125488,111938,303922,
2924,290442,477810,479078,1247330,10044.8318
3532,150,3874,152,4176,
5203,273732,668950,689036,1631718,25575.4328
6885,124476,184262,257918,566656,
2189,275962,236070,153646,665678,
8671,1452,452,44,1948,
9921,50204,3040,36844,90088,
6353,3184,904,1444,5532,
2444,226,518,0,744,
6886,2300234,3371108,3162202,8833544,766354.146800001
2833,92600,97940,138182,328722,12221.9141
5943,151952,218136,132920,503008,
1962,20920,22304,15268,58492,
2722,28562,19886,23468,71916,4262.3089
2873,54778,41818,62510,159106,
9190,95030,92854,144918,332802,
6676,279850,198624,212260,690734,3180.2381
1039,414552,763242,663334,1841128,
7297,6082,7088,2828,15998,
5658,26066,35728,58576,120370,
4606,272198,324748,463330,1060276,
8835,2294,1262,0,3556,
6829,36226,40336,55112,131674,
6090,373136,486932,623270,1483338,22121.3155
4477,52584,33558,4822,90964,
2315,6078,10170,2038,18286,
1087,514598,1097552,834876,2447026,103884.9949
1135,62776,60104,18964,141844,
1084,45488,87016,26434,158938,39722.0154
2291,190608,527340,58610,776558,19661.2712
2294,118292,27024,37990,183306,0.0294
6327,57054,6560,27402,91016,
8174,1682,886,0,2568,
9787,188726,538628,370946,1098300,
5542,154998,52276,69902,277176,
5541,117740,64140,28126,210006,160311.3072
5543,80942,16054,82826,179822,
2977,10056,10048,10162,30266,
5024,55838,222220,125594,403652,
6820,161512,191236,178276,531024,
2798,127102,73758,282244,483104,
2794,402038,380786,365990,1148814,345730.2187
5380,43688,31302,50382,125372,
7318,2904,4808,5638,13350,
5663,462374,1117226,496266,2075866,242143.4273
8561,328250,408676,176228,913154,
3587,9516,41094,27588,78198,
7951,98878,111366,34014,244258,
9547,68888,200442,78914,348244,
8033,752,1146,20,1918,
2673,852,296,1014,2162,
8724,0,144,0,144,
8358,95284,133456,52710,281450,
1261,115486,107438,62698,285622,
5433,218456,307056,483204,1008716,
2249,264082,660284,398808,1323174,159327.0997
5646,32358,58272,65318,155948,
5025,14768,41394,37294,93456,
5525,129396,17772,36320,183488,
3584,28,1390,0,1418,
1149,188780,418906,356954,964640,
5026,53456,90622,170670,314748,
6172,143676,206942,171966,522584,
2388,70548,71506,30292,172346,
9549,9310,15920,2120,27350,
4270,37622,3176,19394,60192,
4108,4896,3488,0,8384,
3056,16424,13708,29070,59202,
6806,136042,147958,242568,526568,
6328,31932,25578,6848,64358,
7224,33410,100200,18464,152074,
8185,201686,711636,65776,979098,3227.8964
8672,124,76,0,200,
9996,103834,207350,113038,424222,
6456,101996,275020,38510,415526,3787.7716
3254,27464,9388,25310,62162,
5333,87988,227128,224206,539322,
2250,171080,400148,193446,764674,
7814,46510,59630,39222,145362,
8178,33686,75360,28548,137594,24038.677
2003,18454,14538,7472,40464,
8007,21972,24996,10192,57160,
3061,41996,32234,76478,150708,
8201,111880,295190,226360,633430,58816.5312
5434,329706,492552,712296,1534554,850.5754
2004,64388,8038,127392,199818,47.943
5179,14606,25424,26396,66426,
1105,501392,957596,1345586,2804574,
2107,73402,46222,566,120190,
6893,739692,1065498,1294094,3099284,
6931,1873868,3088664,3024174,7986706,32454.5158
5124,669482,1347160,2143468,4160110,409867.9371
3205,104470,2798,203550,310818,
3679,141442,25666,86810,253918,40300.0164
1082,1125412,1969140,1920486,5015038,
5638,37206,33968,68240,139414,
5529,194408,53686,43252,291346,
6963,8108,10458,3670,22236,
5929,36946,48488,118518,203952,
9823,32018,81936,60284,174238,
5184,120920,176036,135842,432798,
6691,2757168,5238726,1542158,9538052,1053897.0852
7043,46418,83086,52634,182138,
6888,1051252,1088132,1607188,3746572,1411378.4014
1178,42900,27628,120084,190612,
9587,1732554,2717472,3534016,7984042,26450.8728
5186,10214,21568,13250,45032,
8448,26766,29324,13846,69936,
5605,104636,118070,201012,423718,
7044,25302,46274,39180,110756,
5835,33540,179666,21774,234980,
8257,19376,12756,15356,47488,
7319,47418,143466,19068,209952,
9903,126760,333456,238832,699048,
9552,31970,41674,40296,113940,
4619,50024,59242,56780,166046,
7893,21868,23670,6456,51994,
3150,25436,25180,42016,92632,
8347,574828,826940,342752,1744520,412352.219
7073,102,40,14,156,
3009,2800,1266,2502,6568,
1595,34886,38468,11494,84848,
3206,32036,7436,16290,55762,
6570,15632,12182,11826,39640,
4526,80046,113230,168842,362118,
7455,210278,188780,346704,745762,
5930,42416,32150,41674,116240,
1024,1810334,3378710,2665960,7855004,562975.183400001
5074,8662,19990,15642,44294,
5277,210894,562972,365086,1138952,
5084,413994,382656,836488,1633138,4601.2453
2546,153866,54992,25266,234124,17649.8496
9739,54040,75762,70256,200058,
4387,731476,951224,405120,2087820,237297.5005
5125,783584,854058,1409880,3047522,
1902,38734,30726,46992,116452,
2000,4400,2290,1414,8104,
6782,18810,16894,4544,40248,
6972,400724,599178,580714,1580616,
1968,15312,26772,13808,55892,
9988,131156,240002,289188,660346,
5187,436350,735822,991892,2164064,382329.9482
6265,99746,242848,6414,349008,
4217,27208,4734,11238,43180,
2728,522560,350714,264426,1137700,8032.0273
5154,186834,183092,441010,810936,9679.3363
8450,74210,63000,67736,204946,
9236,15482,11336,5678,32496,
6362,124312,125164,67094,316570,43348.7206
8179,2944,1244,0,4188,
3172,1343188,2210142,2117168,5670498,1648180.6852
4530,37334,33398,61946,132678,
5494,6952,5816,0,12768,
1114,146988,156806,360460,664254,546758.9408
1150,79006,122658,302292,503956,36.3224
2660,41376,85012,41434,167822,
8036,1598,44,540,2182,
5189,56254,66920,126524,249698,
5185,2080,3442,1410,6932,
5126,8308,16970,43342,68620,
4527,432180,795540,656080,1883800,31447.0257
7320,3484,6252,1902,11638,
1452,235862,249150,307230,792242,
7953,13264,6040,4622,23926,
5425,122676,205438,298466,626580,
5410,324574,263564,543396,1131534,
8355,125068,147894,82004,354966,
3138,19388,18054,15668,53110,
9318,176160,115122,205880,497162,
1451,84094,157942,181292,423328,
1453,146152,245260,201192,592604,
5292,34256,29862,49936,114054,
8142,55626,42736,57836,156198,
3057,99794,72408,57112,229314,
7404,90452,113640,205442,409534,
1949,30044,20588,29548,80180,
6892,96322,82322,367920,546564,
3187,584698,955560,1143382,2683640,
5922,618330,700874,523506,1842710,179838.1392
5932,1612292,3413390,1335710,6361392,1068125.7543
5263,32842,66620,58028,157490,
6947,247702,422272,269508,939482,
5339,4610,8358,216,13184,
4787,140710,189176,65760,395646,
7456,662652.287243175,947917.706633091,1427730.98832484,3038300.98220111,18006.3628
7457,375976.749556459,537831.114519545,810068.367023408,1723876.23109941,551.974
7420,409500.963200366,585787.178847365,882298.644651748,1877586.78669948,3621.2229
6890,27368,33844,87190,148402,
2262,555258,2931582,753532,4240372,59957.4052
5286,63538,130650,66984,261172,
8527,162544,169936,76446,408926,
6388,53932,109092,26860,189884,
8836,4228,2034,0,6262,
2199,161834,166520,104424,432778,
1699,11032,472,11972,23476,
7379,324,58,874,1256,
4535,42736,54718,63210,160664,
9997,107404,165772,158010,431186,2057.1249
9175,538,128,212,878,
2666,8444,9482,2046,19972,
1562,49236,83788,31940,164964,
1548,1730822,2521880,3144262,7396964,106816.9346
3252,3464,174,2884,6522,
2672,50214,66110,16560,132884,
3534,40986,343546,88006,472538,
2002,23796,22756,4562,51114,
3590,672,852,2452,3976,
3592,566,5632,1836,8034,
3536,34,1844,0,1878,
5914,111176,104926,89938,306040,67994.2014
3537,8500,227158,16200,251858,184585.2498
3586,6800,29134,24386,60320,
2341,236938,634648,295142,1166728,
2340,104186,186656,94418,385260,5870.3948
5290,53354,46502,83424,183280,
3538,30616,623148,5302,659066,
5751,18142,61872,7790,87804,
6973,263790,418508,477078,1159376,
5059,155944,160468,416382,732794,
3572,44,966,520,1530,
5239,121548,370498,158666,650712,164612.3467
5604,465984,419216,569456,1454656,
6821,128716,130388,117272,376376,
5073,413938,490674,897804,1802416,
2248,278878,368244,359272,1006394,
6110,265806,460036,625638,1351480,
1555,6932002,14919606,11640868,33492476,4584113.50999998
1268,718016,1026782,584692,2329490,303156.4022
5670,893632,927648,950194,2771474,379040.7356
6287,6580,3404,618,10602,
2983,281666,401918,467302,1150886,122997.3983
6140,159342,122714,73476,355532,
6968,135802,221068,222360,579230,
7458,363672,253016,518356,1135044,
2159,86,22,20,128,
6834,5077174,2470580,84354,7632108,30001.5191
6833,141360,160420,268080,569860,8115.9293
5228,112412,268074,470754,851240,
3250,101438,52322,30020,183780,
8221,77518,63216,45464,186198,
3413,19390,90768,32692,142850,
1977,10046,19450,12882,42378,
1043,81786,113226,270248,465260,
8469,276608,296984,278016,851608,
9842,72886,110748,86246,269880,
6092,1436600,1968196,1441822,4846618,302503.1663
9553,26310,69148,22054,117512,
1386,5746,11444,19786,36976,
9554,68446,140060,102096,310602,
9888,689268,1303256,345132,2337656,284521.831
2771,973842,1944636,863240,3781718,858142.871000001
7513,19664,20772,19334,59770,
8451,10362,8522,3970,22854,
7975,36894,31378,12352,80624,
1467,65404,74886,178204,318494,
6934,339654,510246,517118,1367018,
1314,869100,1823252,400274,3092626,214945.6127
1316,69414,38296,19898,127608,
5248,45362,28322,120924,194608,
1454,198686,331826,280406,810918,
5240,22788,60674,93342,176804,
8964,162040,233470,109240,504750,
4770,23176,105012,23900,152088,
5606,307384,317760,444618,1069762,
4646,244188,572564,650214,1466966,482540.4545
4643,94214,195556,285636,575406,
9396,25406,30824,11244,67474,
7355,210774,356046,384576,951396,49939.0983
9555,19308,42954,20,62282,
6969,9296922,15287486,17667184,42251592,3872501.27300001
7222,437094,1129326,569520,2135940,
6794,28568,42768,9748,81084,1803.556
4558,140686,491554,404418,1036658,3.0509
8673,5056,2560,62,7678,
5607,323582,302806,266938,893326,200.2889
5383,622196,682852,1402518,2707566,477135.7797
5384,680360,1149562,2247218,4077140,118787.0331
5435,485780,698988,1039068,2223836,
8543,12996,11798,564,25358,
2834,4132,5534,16666,26332,
8674,926,328,0,1254,
5191,277146,447536,407374,1132056,476684.1779
4771,49210,393650,85960,528820,0.434
5029,16180,29798,38052,84030,
2868,1640,1954,1178,4772,
7098,60962,132070,127010,320042,
1483,11900,2736,23106,37742,
1484,25442,11262,32050,68754,
4157,96,126,6,228,
9959,20080,59548,19414,99042,
5608,112742,110326,211810,434878,
7640,195388,247276,41172,483836,5772.8715
5155,85712,57192,97840,240744,
5671,260266,237660,188714,686640,
5675,14416,14392,13520,42328,
5571,2350496,3248592,3777608,9376696,730398.5795
1083,902240,1825210,1943904,4671354,373445.0046
5385,1557652,2014046,2954454,6526152,532618.9253
1044,267896,468100,872696,1608692,
5436,103066,77282,136106,316454,
1861,78712,55850,47646,182208,
5249,2204,1346,908,4458,
5075,331072,543004,483812,1357888,143083.2226
5156,38494,52738,82326,173558,
4222,893160,850902,386092,2130154,86660.0348000002
5920,207894,184332,206742,598968,
5884,30616,39356,44066,114038,
5933,39198,35998,57092,132288,
6355,8790,1026,4646,14462,
3333,672600,1988908,1017734,3679242,247024.050599999
6228,710,84,2892,3686,
2800,45514,44424,47424,137362,
6686,146948,129248,119636,395832,3509.8779
5437,967636,1497610,1816908,4282154,
5085,191160,206262,351490,748912,
5609,461802,269338,708376,1439516,
1900,120358,28074,70038,218470,
3195,5596,10642,6256,22494,
5386,75858,75368,102278,253504,
3880,187620,15772,158214,361606,
8676,20578,6972,1072,28622,
4479,4608,1424,0,6032,
4355,17396,8022,2672,28090,
2463,764,508,56,1328,
1010,106608,206216,276032,588856,
1322,524572,445976,228152,1198700,354324.421399999
3151,72766,88524,113108,274398,
5387,61110,63620,104082,228812,
3471,273882,1015980,143298,1433160,79435.2807
8727,14214,5690,2012,21916,
5572,674496,747390,812184,2234070,97805.4097000001
7521,22,8,0,30,
3430,67480,453488,160078,681046,
4691,325344,556940,325122,1207406,11837.3753
5837,23430,75528,27718,126676,
4110,80936,41852,526,123314,
5193,25974,38788,57060,121822,
5610,304576,273174,289458,867208,
3152,118986,225580,236488,581054,
2264,68732,111144,56890,236766,
4523,73742,167062,195758,436562,
4538,4120,5358,4410,13888,
3153,150250,143932,199874,494056,
6949,137918,196366,79652,413936,
7203,68080,170058,64782,302920,1.623
8191,63950,139668,19992,223610,
7976,213050,297310,123600,633960,38371.4614
6530,72808,63922,52028,188758,1868.0371
6531,34650,29556,23128,87334,8.1084
5849,840,1704,0,2544,
9812,58288,121748,103248,283284,
6210,558,422,60,1040,
5388,600026,1011768,1779010,3390804,
9825,4292,8470,3986,16748,
7460,311744,223030,344894,879668,
6267,170,40,0,210,
6857,25766,40074,68324,134164,275248.1664
5491,601620,1108554,1361506,3071680,737322.504500001
5028,1736,3514,1398,6648,
6203,1832,116,522,2470,
8282,27060,28488,20568,76116,
8677,16418,20708,196,37322,
7356,24350,22004,22904,69258,
7462,351314,224264,448350,1023928,30453.0678
1035,149562,232660,282060,664282,
3154,90820,157108,303866,551794,
1159,66302,133632,134648,334582,
4025,15344,1648,5994,22986,
5798,47620,127478,64382,239480,
3474,66932,375874,49936,492742,
2677,180830,277238,149368,607436,
5573,162788,162278,278400,603466,
3897,35422,5224,34338,74984,
5229,697932,1327308,2389154,4414394,509897.987699999
4271,26880,3072,17274,47226,
4432,1778,970,10,2758,
3882,56346,7726,50768,114840,
5389,247378,229672,551068,1028118,
5758,30294,179552,40436,250282,
3434,37824,412536,55024,505384,1064.8268
3432,39430,126180,129466,295076,
3558,64106,532212,71412,667730,
6951,2300000,3114196,2524804,7939000,367257.6199
5921,88820,90452,114010,293282,
2283,86898,180968,117108,384974,
2969,28006,13258,23448,64712,
3887,546580,35574,227776,809930,
3886,57304,3236,32132,92672,
3888,22802,2724,11786,37312,
3889,292478,24928,191218,508624,
3891,63144,7052,116330,186526,
7225,13582,12382,6924,32888,
1393,247756,305644,306766,860166,84.1291
4276,23068,3526,11764,38358,
9562,180098,375566,200736,756400,8601.8173
3348,377954,380796,224954,983704,35752.2407
3540,106236,813158,283548,1202942,219230.303
8837,1278,338,0,1616,
5390,560132,666794,951696,2178622,407915.675099999
5230,608488,1417912,1794160,3820560,90094.5731
6952,212528,320062,178982,711572,
1783,32426,31380,5136,68942,
9500,124908,283978,27346,436232,
5574,1668820,2278466,1976730,5924016,458582.813899999
3155,300674,499674,583090,1383438,667442.9154
2439,2960,1120,1346,5426,
3817,100332,7472,96354,204158,
4357,1530,272,0,1802,
8728,4372,1118,20,5510,
4518,51336,41100,127136,219572,8793.738
4433,58304,27622,18312,104238,
5334,49454,93220,298950,441624,
9776,221940,342810,311250,876000,
6211,4094,2274,230,6598,
8261,3880,2664,1832,8376,
2010,99344,156984,45490,301818,
5826,1908,25486,9682,37076,
4504,859006,1330670,1193410,3383086,
9373,211490,228626,168460,608576,
2364,15314,9712,5948,30974,
7464,2014564,2361492,1607950,5984006,903658.001
5613,27770,24624,71990,124384,
1524,109188,106740,199252,415180,
8838,2602,1910,0,4512,12.007
5391,221462,270584,440024,932070,6.739
2141,22990,6098,3652,32740,
5967,15134,30072,4482,49688,31545.1258
2938,121190,145306,114090,380586,
1342,61648,82238,14524,158410,
2440,9438,3286,2338,15062,
5597,4445670,5990996,12046212,22482878,
5426,17276368,28046022,30567006,75889396,5734423.6609
5676,205472,214088,173532,593092,97276.0462
5392,176308,188408,262344,627060,
5231,58376,155786,205262,419424,
6268,31528,11296,3502,46326,
8584,176979.416411043,261246.288726994,101252.087806748,539477.792944785,139251.2189
8591,833556.583588957,1230445.71127301,476887.912193252,2540890.20705521,162748.3454
2612,89418,83606,127686,300710,
2154,202250,174274,111896,488420,
2265,174306,175964,113872,464142,
5394,486786,658644,721420,1866850,
9365,114108,75756,107132,296996,
5041,38282,66908,83212,188402,
1216,281132,535674,651072,1467878,13331.6145
2665,21738,32480,51742,105960,
6823,334706,428380,349510,1112596,
6953,959558,1434714,1626558,4020830,
7407,57690,67034,94008,218732,
2251,65678,113528,82536,261742,
6858,17936,65286,49074,132296,
5575,741392,774926,1400568,2916886,
5639,50106,26490,30094,106690,
5395,383868,458602,629924,1472394,
5372,211796,230290,370886,812972,
5576,951658,1057570,2077798,4087026,
7408,41606,60056,110910,212572,40.3866
1085,623372,1122558,737882,2483812,
5264,6426,7316,12190,25932,
6824,375568,403684,375038,1154290,
5959,90886,209246,42254,342386,
3158,24584,22440,49614,96638,
5505,124116,199564,61166,384846,13960.501
5316,3678,2882,5390,11950,
2384,464898.988002087,670777.485654669,227892.57694314,1363569.0505999,591072.9906
2390,589789.011997913,850974.514345331,289113.42305686,1729876.9494001,348277.9559
4600,163040,250054,181838,594932,
8530,159132,389508,110788,659428,
1121,25794,1888,23998,51680,
7079,109504,157734,172904,440142,
5241,11336,16050,20698,48084,
5598,21769098,32589004,45044994,99403096,6105767.74960001
5158,2101466,3182218,5040858,10324542,1132947.3882
2133,343148,768474,466396,1578018,
1455,284916,1044736,113964,1443616,
1402,2165952,4060514,2043488,8269954,591567.3619
1403,19650,35068,55100,109818,
7057,28894,74850,40370,144114,
6095,48986,42170,76596,167752,
3796,52398,4030,32224,88652,
8589,163208,181560,188722,533490,
6859,7744,9200,14876,31820,
8509,29564,26366,26532,82462,
6073,73062,58404,82068,213534,
5128,630898,629136,1407088,2667122,
1940,136550,354028,499150,989728,165.8046
4690,244642,167730,253406,665778,
4434,104404,57338,8906,170648,
6183,898490,1003164,1049294,2950948,67696.5712
6096,156280,196740,245944,598964,
1347,44978,43728,16338,105044,
1423,617030,1597684,1127522,3342236,75185.2328999999
1509,137670,512026,155128,804824,
9673,68726,102104,30398,201228,
1466,113328,132046,256994,502368,
2681,2374,2020,0,4394,
2266,25442,44962,27222,97626,
8875,1310808,1964094,1951514,5226416,
5684,343996,363760,712308,1420064,
9250,41540,50192,40502,132234,
5411,1254672,2190876,2086894,5532442,607062.052400001
3174,550996,824208,691182,2066386,
5086,334990,364772,422058,1121820,
3188,239660,206276,477774,923710,53930.153
7474,2827468,3881258,3920900,10629626,8790.8081
1421,971124,1432836,2318172,4722132,694996.8908
1525,902018,1024454,1763718,3690190,997080.709700002
7466,152800,67002,183152,402954,
9564,43220,87716,33816,164752,
2201,262274,652466,180510,1095250,
5129,156040,298602,398124,852766,
5438,442162,620754,874166,1937082,22492.8667
3059,94520,60026,34788,189334,4114.1322
7329,12634,11918,1634,26186,
5242,22466,36246,49020,107732,
5293,112028,93782,142204,348014,
5054,281668,246540,411580,939788,
5278,94214,275916,250606,620736,
5712,184852,298004,95400,578256,243963.9964
7476,405616,337212,516972,1259800,
5151,222892,197758,365358,786008,
5030,10532,19672,33828,64032,
9231,16900,13180,6000,36080,
7226,3976,4330,1274,9580,3181.0784
9998,172282,378872,242940,794094,31114.1015
5195,28182,50286,71582,150050,
2619,55694,83636,55422,194752,
3388,28144,27960,12490,68594,
3391,224694,662522,260372,1147588,12442.2546
7572,10144,11676,1052,22872,
5577,851270,618472,1003012,2472754,688162.9783
5965,136480,610134,33368,779982,7990.2059
2772,31884,59014,40442,131340,
2736,32536,35582,15064,83182,
1585,8434,17604,1806,27844,
9753,81258,141002,107328,329588,13120.0486
5759,16702,36080,9072,61854,
9665,10782,26048,6866,43696,
2161,72640,173138,121352,367130,
8184,55378,34936,41496,131810,
5527,45314,72720,167112,285146,
1348,73846,49342,15058,138246,
3896,13412,1282,8408,23102,
6956,311880,606120,727056,1645056,
6846,1866,1662,7024,10552,
4935,3343710,5708712,5075532,14127954,
9777,104324,120768,93266,318358,
2048,96190,127696,26906,250792,
4111,36750,12138,2044,50932,3374.9448
8130,772,10,0,782,
4539,66188,54956,26670,147814,
5196,98170,385970,360646,844786,
7187,13162,5632,11680,30474,
7047,103694,173190,232860,509744,
5611,440414,441720,511444,1393578,
6551,8482,8354,3540,20376,
5396,86442,90650,109050,286142,
5439,40728,40604,63132,144464,
8680,8746,9640,52,18438,
6891,432338,475014,1437146,2344498,543388.065
7227,11628,27434,7330,46392,
7695,1716,214,1416,3346,
2391,202942,216482,95464,514888,
4528,74956,96230,211052,382238,
2363,401142.270237371,793132.970176506,426002.318928789,1620277.55934267,649092.812700001
2406,369707.729762629,730981.029823494,392619.681071211,1493308.44065733,136101.8954
2098,18996,23116,7012,49124,
3965,11766,4800,8848,25414,
1457,1562712,2331550,2302542,6196804,2513016.902
9781,69444,92150,96292,257886,
1905,17948,7470,6104,31522,
4568,9400,10796,3170,23366,
2774,518044,619094,393816,1530954,107784.5078
1056,51482,6630,53498,111610,
5578,4781606,6709308,8658636,20149550,1205727.8017
5612,86186,63844,140248,290278,
5042,724,4284,2570,7578,
5924,1012888,1849526,2220850,5083264,87076.7961
5528,59782,91802,219074,370658,
6024,545412,512596,632228,1690236,
1978,73968,304174,37306,415448,
3175,358414,1073666,488486,1920566,41887.6956
5672,436156,718808,290776,1445740,44695.8339
5697,141718,146568,234692,522978,
5698,174180,105590,189584,469354,
2269,81228,132214,20008,233450,
9694,148496,220636,181480,550612,
6844,323696,520574,1499702,2343972,139297.736
5640,74058,53480,162258,289796,
1011,40302,109496,132944,282742,
5341,72924,134326,212204,419454,29934.1673
6860,44140,150234,198676,393050,2695.2951
1539,9918,15040,13984,38942,
5685,2189008,2426984,3381516,7997508,1734053.3053
5696,679964,914204,850398,2444566,142274.3999
5440,51270,75906,162160,289336,
1218,1052406,2511408,1356542,4920356,360907.1682
1364,65876,94656,305424,465956,
6688,93692,68134,53344,215170,
4536,4766,4088,4458,13312,
6954,345148,495478,476734,1317360,
7228,48652,122988,33014,204654,
7467,37932,51804,106508,196244,
9639,12150,19560,28406,60116,
6732,13950,9280,10292,33522,
8578,155162,107464,81204,343830,
2835,23474,19236,18172,60882,
5441,76862,81210,143172,301244,
2773,64652,60322,128772,253746,
5960,53040,114098,25428,192566,
5925,59384,42476,60726,162586,
5152,864930,1203004,1579732,3647666,
5153,80242,105892,235462,421596,
4540,2718,3988,2242,8948,
4893,588262.386730371,692291.178941675,820272.690886145,2100826.25655819,195986.1797
5579,623102,676586,1066704,2366392,
4891,229071.613269629,269580.821058325,319417.309113856,818069.74344181,138675.084
2040,70036,83974,32566,186576,
6574,203348,189470,97458,490276,23968.1624
3390,125764,148352,47190,321306,
5686,43834,23038,145410,212282,
7326,8008,10250,6394,24652,
5279,376620,1088776,638876,2104272,75894.0541
6907,3402,6092,15678,25172,
5673,38758,30968,40576,110302,
1350,8164,2700,932,11796,
8123,180,274,10,464,
4486,54532,17872,1780,74184,
4487,285042,193794,43382,522218,10894.85
5031,37996,72466,85716,196178,
7514,32174,48676,27114,107964,
1138,125728,202232,278126,606086,
7383,48790,99518,39916,188224,
4532,15632,19978,20134,55744,
5232,6714,8656,10174,25544,
4537,118112,142736,187682,448530,
7917,34940,87960,24158,147058,
3380,136596,141430,114884,392910,
3392,137706,196040,110060,443806,
5827,3024,12868,2688,18580,
5838,37450,184012,17028,238490,11602.6082
5856,38244,96600,6170,141014,12669.4133
5857,2484,4278,428,7190,
3818,8792,822,3732,13346,
9990,43260,77396,31460,152116,
8263,1427860,6588038,1248192,9264090,1449286.1253
1351,5346,1378,2064,8788,
4026,175378,10502,162928,348808,
3871,34620,4498,17280,56398,
,:,:,:,:,
,:,:,:,:,
,:,:,:,:,
,:,:,:,:,
